Season,Date,GameID,Team,TeamID,Is_Home,Opp,G,A,PTS,SOG,HIT,BLK,GA,AA,PTSA,SOGA,HITA,BLKA
2024-25,11/9/2024,202411090BUF,Buffalo Sabres,BUF,1,CGY,2,4,6,19,18,19,2,4,6,26,20,15
2024-25,11/9/2024,202411090FLA,Florida Panthers,FLA,1,PHI,3,6,9,31,16,7,3,6,9,37,23,16
2024-25,11/9/2024,202411090BOS,Boston Bruins,BOS,1,OTT,2,4,6,16,42,16,3,4,7,34,35,13
2024-25,11/9/2024,202411090TOR,Toronto Maple Leafs,TOR,1,MTL,4,7,11,27,24,21,1,2,3,21,20,7
2024-25,11/9/2024,202411090DET,Detroit Red Wings,DET,1,NYR,0,0,0,37,5,14,4,7,11,24,25,22
2024-25,11/9/2024,202411090STL,St. Louis Blues,STL,1,WSH,1,2,3,25,25,7,8,15,23,27,18,18
2024-25,11/9/2024,202411090WPG,Winnipeg Jets,WPG,1,DAL,4,7,11,25,18,17,1,2,3,33,18,9
2024-25,11/9/2024,202411090NYI,New York Islanders,NYI,1,NJD,3,5,8,22,34,13,4,7,11,33,24,10
2024-25,11/9/2024,202411090COL,Colorado Avalanche,COL,1,CAR,6,9,15,29,7,10,4,8,12,31,16,13
2024-25,11/9/2024,202411090LAK,Los Angeles Kings,LAK,1,CBJ,5,9,14,23,8,22,2,3,5,26,16,12
2024-25,11/9/2024,202411090VAN,Vancouver Canucks,VAN,1,EDM,3,5,8,20,34,11,7,13,20,31,10,8
2024-25,11/9/2024,202411090NSH,Nashville Predators,NSH,1,ARI,4,5,9,21,35,12,0,0,0,26,18,9
2024-25,11/9/2024,202411090BUF,Calgary Flames,CGY,0,BUF,2,4,6,26,20,15,2,4,6,19,18,19
2024-25,11/9/2024,202411090FLA,Philadelphia Flyers,PHI,0,FLA,3,6,9,37,23,16,3,6,9,31,16,7
2024-25,11/9/2024,202411090BOS,Ottawa Senators,OTT,0,BOS,3,4,7,34,35,13,2,4,6,16,42,16
2024-25,11/9/2024,202411090TOR,Montreal Canadiens,MTL,0,TOR,1,2,3,21,20,7,4,7,11,27,24,21
2024-25,11/9/2024,202411090DET,New York Rangers,NYR,0,DET,4,7,11,24,25,22,0,0,0,37,5,14
2024-25,11/9/2024,202411090STL,Washington Capitals,WSH,0,STL,8,15,23,27,18,18,1,2,3,25,25,7
2024-25,11/9/2024,202411090WPG,Dallas Stars,DAL,0,WPG,1,2,3,33,18,9,4,7,11,25,18,17
2024-25,11/9/2024,202411090NYI,New Jersey Devils,NJD,0,NYI,4,7,11,33,24,10,3,5,8,22,34,13
2024-25,11/9/2024,202411090COL,Carolina Hurricanes,CAR,0,COL,4,8,12,31,16,13,6,9,15,29,7,10
2024-25,11/9/2024,202411090LAK,Columbus Blue Jackets,CBJ,0,LAK,2,3,5,26,16,12,5,9,14,23,8,22
2024-25,11/9/2024,202411090VAN,Edmonton Oilers,EDM,0,VAN,7,13,20,31,10,8,3,5,8,20,34,11
2024-25,11/9/2024,202411090NSH,Arizona Coyotes,ARI,0,NSH,0,0,0,26,18,9,4,5,9,21,35,12
2024-25,11/8/2024,202411080TOR,Detroit Red Wings,DET,0,TOR,1,2,3,22,14,18,3,4,7,20,23,20
2024-25,11/8/2024,202411080TOR,Toronto Maple Leafs,TOR,1,DET,3,4,7,20,23,20,1,2,3,22,14,18
2024-25,11/8/2024,202411080WSH,Pittsburgh Penguins,PIT,0,WSH,4,6,10,32,19,18,2,4,6,34,20,16
2024-25,11/8/2024,202411080WSH,Washington Capitals,WSH,1,PIT,2,4,6,34,20,16,4,6,10,32,19,18
2024-25,11/8/2024,202411080ANA,Minnesota Wild,MIN,0,ANA,5,8,13,31,9,21,2,2,4,35,21,18
2024-25,11/8/2024,202411080ANA,Anaheim Ducks,ANA,1,MIN,2,2,4,35,21,18,5,8,13,31,9,21
2024-25,11/8/2024,202411080SEA,Vegas Golden Knights,VEG,0,SEA,3,6,9,24,26,10,4,2,6,32,31,16
2024-25,11/8/2024,202411080SEA,Seattle Kraken,SEA,1,VEG,4,2,6,32,31,16,3,6,9,24,26,10
2024-25,11/7/2024,202411070BOS,Boston Bruins,BOS,1,CGY,4,5,9,38,22,12,3,5,8,37,12,17
2024-25,11/7/2024,202411070OTT,Ottawa Senators,OTT,1,NYI,2,4,6,30,31,15,4,7,11,25,20,22
2024-25,11/7/2024,202411070TBL,Tampa Bay Lightning,TBL,1,PHI,1,2,3,23,14,13,1,1,2,31,23,16
2024-25,11/7/2024,202411070FLA,Florida Panthers,FLA,1,NSH,6,12,18,34,21,10,2,4,6,18,39,13
2024-25,11/7/2024,202411070NJD,New Jersey Devils,NJD,1,MTL,5,6,11,27,22,14,3,5,8,24,25,13
2024-25,11/7/2024,202411070NYR,New York Rangers,NYR,1,BUF,1,2,3,26,34,10,6,11,17,22,17,21
2024-25,11/7/2024,202411070CAR,Carolina Hurricanes,CAR,1,PIT,5,10,15,17,11,18,1,0,1,36,28,12
2024-25,11/7/2024,202411070STL,St. Louis Blues,STL,1,ARI,2,3,5,15,30,18,4,6,10,31,21,17
2024-25,11/7/2024,202411070DAL,Dallas Stars,DAL,1,CHI,3,6,9,40,15,11,1,2,3,26,39,22
2024-25,11/7/2024,202411070WPG,Winnipeg Jets,WPG,1,COL,1,1,2,28,10,15,0,0,0,35,18,15
2024-25,11/7/2024,202411070LAK,Los Angeles Kings,LAK,1,VAN,2,4,6,28,26,21,4,2,6,23,33,18
2024-25,11/7/2024,202411070SJS,San Jose Sharks,SJS,1,MIN,2,4,6,26,20,17,5,8,13,31,16,9
2024-25,11/7/2024,202411070BOS,Calgary Flames,CGY,0,BOS,3,5,8,37,12,17,4,5,9,38,22,12
2024-25,11/7/2024,202411070OTT,New York Islanders,NYI,0,OTT,4,7,11,25,20,22,2,4,6,30,31,15
2024-25,11/7/2024,202411070TBL,Philadelphia Flyers,PHI,0,TBL,1,1,2,31,23,16,1,2,3,23,14,13
2024-25,11/7/2024,202411070FLA,Nashville Predators,NSH,0,FLA,2,4,6,18,39,13,6,12,18,34,21,10
2024-25,11/7/2024,202411070NJD,Montreal Canadiens,MTL,0,NJD,3,5,8,24,25,13,5,6,11,27,22,14
2024-25,11/7/2024,202411070NYR,Buffalo Sabres,BUF,0,NYR,6,11,17,22,17,21,1,2,3,26,34,10
2024-25,11/7/2024,202411070CAR,Pittsburgh Penguins,PIT,0,CAR,1,0,1,36,28,12,5,10,15,17,11,18
2024-25,11/7/2024,202411070STL,Arizona Coyotes,ARI,0,STL,4,6,10,31,21,17,2,3,5,15,30,18
2024-25,11/7/2024,202411070DAL,Chicago Blackhawks,CHI,0,DAL,1,2,3,26,39,22,3,6,9,40,15,11
2024-25,11/7/2024,202411070WPG,Colorado Avalanche,COL,0,WPG,0,0,0,35,18,15,1,1,2,28,10,15
2024-25,11/7/2024,202411070LAK,Vancouver Canucks,VAN,0,LAK,4,2,6,23,33,18,2,4,6,28,26,21
2024-25,11/7/2024,202411070SJS,Minnesota Wild,MIN,0,SJS,5,8,13,31,16,9,2,4,6,26,20,17
2024-25,11/6/2024,202411060WSH,Washington Capitals,WSH,1,NSH,3,6,9,36,34,19,2,4,6,35,34,20
2024-25,11/6/2024,202411060CHI,Chicago Blackhawks,CHI,1,DET,1,2,3,29,22,15,4,5,9,25,7,15
2024-25,11/6/2024,202411060EDM,Edmonton Oilers,EDM,1,VEG,2,2,4,29,29,8,4,8,12,35,16,14
2024-25,11/6/2024,202411060WSH,Nashville Predators,NSH,0,WSH,2,4,6,35,34,20,3,6,9,36,34,19
2024-25,11/6/2024,202411060CHI,Detroit Red Wings,DET,0,CHI,4,5,9,25,7,15,1,2,3,29,22,15
2024-25,11/6/2024,202411060EDM,Vegas Golden Knights,VEG,0,EDM,4,8,12,35,16,14,2,2,4,29,29,8
2024-25,11/5/2024,202411050BUF,Buffalo Sabres,BUF,1,OTT,5,9,14,34,37,11,1,2,3,38,35,11
2024-25,11/5/2024,202411050TOR,Toronto Maple Leafs,TOR,1,BOS,4,7,11,27,19,12,0,0,0,29,32,10
2024-25,11/5/2024,202411050MTL,Montreal Canadiens,MTL,1,CGY,2,3,5,23,25,22,3,3,6,36,29,13
2024-25,11/5/2024,202411050CAR,Carolina Hurricanes,CAR,1,PHI,6,8,14,35,13,9,4,7,11,16,18,20
2024-25,11/5/2024,202411050NYI,New York Islanders,NYI,1,PIT,3,6,9,26,21,14,3,6,9,35,23,10
2024-25,11/5/2024,202411050STL,St. Louis Blues,STL,1,TBL,3,5,8,23,24,18,2,3,5,23,12,11
2024-25,11/5/2024,202411050MIN,Minnesota Wild,MIN,1,LAK,1,2,3,24,11,9,5,10,15,28,25,13
2024-25,11/5/2024,202411050WPG,Winnipeg Jets,WPG,1,ARI,3,6,9,28,24,18,0,0,0,21,19,5
2024-25,11/5/2024,202411050COL,Colorado Avalanche,COL,1,SEA,6,12,18,32,20,22,3,5,8,20,22,21
2024-25,11/5/2024,202411050ANA,Anaheim Ducks,ANA,1,VAN,1,2,3,22,16,19,5,10,15,37,17,7
2024-25,11/5/2024,202411050SJS,San Jose Sharks,SJS,1,CBJ,2,3,5,27,23,16,1,2,3,50,17,11
2024-25,11/5/2024,202411050BUF,Ottawa Senators,OTT,0,BUF,1,2,3,38,35,11,5,9,14,34,37,11
2024-25,11/5/2024,202411050TOR,Boston Bruins,BOS,0,TOR,0,0,0,29,32,10,4,7,11,27,19,12
2024-25,11/5/2024,202411050MTL,Calgary Flames,CGY,0,MTL,3,3,6,36,29,13,2,3,5,23,25,22
2024-25,11/5/2024,202411050CAR,Philadelphia Flyers,PHI,0,CAR,4,7,11,16,18,20,6,8,14,35,13,9
2024-25,11/5/2024,202411050NYI,Pittsburgh Penguins,PIT,0,NYI,3,6,9,35,23,10,3,6,9,26,21,14
2024-25,11/5/2024,202411050STL,Tampa Bay Lightning,TBL,0,STL,2,3,5,23,12,11,3,5,8,23,24,18
2024-25,11/5/2024,202411050MIN,Los Angeles Kings,LAK,0,MIN,5,10,15,28,25,13,1,2,3,24,11,9
2024-25,11/5/2024,202411050WPG,Arizona Coyotes,ARI,0,WPG,0,0,0,21,19,5,3,6,9,28,24,18
2024-25,11/5/2024,202411050COL,Seattle Kraken,SEA,0,COL,3,5,8,20,22,21,6,12,18,32,20,22
2024-25,11/5/2024,202411050ANA,Vancouver Canucks,VAN,0,ANA,5,10,15,37,17,7,1,2,3,22,16,19
2024-25,11/5/2024,202411050SJS,Columbus Blue Jackets,CBJ,0,SJS,1,2,3,50,17,11,2,3,5,27,23,16
2024-25,11/4/2024,202411040EDM,Edmonton Oilers,EDM,1,NJD,0,0,0,31,5,9,3,5,8,16,19,14
2024-25,11/4/2024,202411040NSH,Nashville Predators,NSH,1,LAK,0,0,0,16,21,14,3,6,9,27,12,12
2024-25,11/4/2024,202411040EDM,New Jersey Devils,NJD,0,EDM,3,5,8,16,19,14,0,0,0,31,5,9
2024-25,11/4/2024,202411040NSH,Los Angeles Kings,LAK,0,NSH,3,6,9,27,12,12,0,0,0,16,21,14
2024-25,11/3/2024,202411030CAR,Washington Capitals,WSH,0,CAR,2,3,5,21,20,16,4,5,9,45,10,11
2024-25,11/3/2024,202411030ANA,Chicago Blackhawks,CHI,0,ANA,4,8,12,29,5,26,2,3,5,39,15,7
2024-25,11/3/2024,202411030CGY,Edmonton Oilers,EDM,0,CGY,4,6,10,31,19,25,2,3,5,31,13,15
2024-25,11/3/2024,202411030WPG,Tampa Bay Lightning,TBL,0,WPG,4,4,8,30,16,5,7,10,17,34,31,13
2024-25,11/3/2024,202411030NYR,New York Islanders,NYI,0,NYR,2,4,6,37,17,10,5,8,13,40,19,18
2024-25,11/3/2024,202411030BOS,Seattle Kraken,SEA,0,BOS,0,0,0,23,18,15,2,4,6,33,15,27
2024-25,11/3/2024,202411030MIN,Toronto Maple Leafs,TOR,0,MIN,1,2,3,28,30,24,2,4,6,33,22,8
2024-25,11/3/2024,202411030CAR,Carolina Hurricanes,CAR,1,WSH,4,5,9,45,10,11,2,3,5,21,20,16
2024-25,11/3/2024,202411030ANA,Anaheim Ducks,ANA,1,CHI,2,3,5,39,15,7,4,8,12,29,5,26
2024-25,11/3/2024,202411030CGY,Calgary Flames,CGY,1,EDM,2,3,5,31,13,15,4,6,10,31,19,25
2024-25,11/3/2024,202411030WPG,Winnipeg Jets,WPG,1,TBL,7,10,17,34,31,13,4,4,8,30,16,5
2024-25,11/3/2024,202411030NYR,New York Rangers,NYR,1,NYI,5,8,13,40,19,18,2,4,6,37,17,10
2024-25,11/3/2024,202411030BOS,Boston Bruins,BOS,1,SEA,2,4,6,33,15,27,0,0,0,23,18,15
2024-25,11/3/2024,202411030MIN,Minnesota Wild,MIN,1,TOR,2,4,6,33,22,8,1,2,3,28,30,24
2024-25,11/2/2024,202411020PIT,Montreal Canadiens,MTL,0,PIT,1,2,3,26,28,24,3,4,7,24,19,19
2024-25,11/2/2024,202411020LAK,Chicago Blackhawks,CHI,0,LAK,3,5,8,21,25,17,3,6,9,40,24,13
2024-25,11/2/2024,202411020OTT,Seattle Kraken,SEA,0,OTT,0,0,0,22,14,15,3,5,8,23,25,14
2024-25,11/2/2024,202411020SJS,Vancouver Canucks,VAN,0,SJS,3,6,9,27,24,13,2,3,5,23,21,22
2024-25,11/2/2024,202411020PHI,Boston Bruins,BOS,0,PHI,3,5,8,31,22,18,0,0,0,20,30,19
2024-25,11/2/2024,202411020NSH,Colorado Avalanche,COL,0,NSH,2,4,6,28,23,15,5,7,12,25,23,25
2024-25,11/2/2024,202411020WSH,Columbus Blue Jackets,CBJ,0,WSH,2,3,5,36,17,10,7,13,20,22,14,30
2024-25,11/2/2024,202411020DET,Buffalo Sabres,BUF,0,DET,1,0,1,32,17,18,2,3,5,23,11,16
2024-25,11/2/2024,202411020FLA,Dallas Stars,DAL,0,FLA,2,4,6,25,26,6,4,6,10,25,22,16
2024-25,11/2/2024,202411020VEG,Arizona Coyotes,ARI,0,VEG,3,6,9,19,21,9,4,7,11,35,22,14
2024-25,11/2/2024,202411020STL,Toronto Maple Leafs,TOR,0,STL,2,3,5,37,18,13,4,5,9,24,17,17
2024-25,11/2/2024,202411020PIT,Pittsburgh Penguins,PIT,1,MTL,3,4,7,24,19,19,1,2,3,26,28,24
2024-25,11/2/2024,202411020LAK,Los Angeles Kings,LAK,1,CHI,3,6,9,40,24,13,3,5,8,21,25,17
2024-25,11/2/2024,202411020OTT,Ottawa Senators,OTT,1,SEA,3,5,8,23,25,14,0,0,0,22,14,15
2024-25,11/2/2024,202411020SJS,San Jose Sharks,SJS,1,VAN,2,3,5,23,21,22,3,6,9,27,24,13
2024-25,11/2/2024,202411020PHI,Philadelphia Flyers,PHI,1,BOS,0,0,0,20,30,19,3,5,8,31,22,18
2024-25,11/2/2024,202411020NSH,Nashville Predators,NSH,1,COL,5,7,12,25,23,25,2,4,6,28,23,15
2024-25,11/2/2024,202411020WSH,Washington Capitals,WSH,1,CBJ,7,13,20,22,14,30,2,3,5,36,17,10
2024-25,11/2/2024,202411020DET,Detroit Red Wings,DET,1,BUF,2,3,5,23,11,16,1,0,1,32,17,18
2024-25,11/2/2024,202411020FLA,Florida Panthers,FLA,1,DAL,4,6,10,25,22,16,2,4,6,25,26,6
2024-25,11/2/2024,202411020VEG,Vegas Golden Knights,VEG,1,ARI,4,7,11,35,22,14,3,6,9,19,21,9
2024-25,11/2/2024,202411020STL,St. Louis Blues,STL,1,TOR,4,5,9,24,17,17,2,3,5,37,18,13
2024-25,11/1/2024,202411010CGY,New Jersey Devils,NJD,0,CGY,0,0,0,22,22,15,3,3,6,32,30,18
2024-25,11/1/2024,202411010CGY,Calgary Flames,CGY,1,NJD,3,3,6,32,30,18,0,0,0,22,22,15
2024-25,11/1/2024,202411010NYR,Ottawa Senators,OTT,0,NYR,1,2,3,41,28,8,2,3,5,18,28,23
2024-25,11/1/2024,202411010NYR,New York Rangers,NYR,1,OTT,2,3,5,18,28,23,1,2,3,41,28,8
2024-25,11/1/2024,202411010CBJ,Winnipeg Jets,WPG,0,CBJ,6,7,13,44,17,11,2,3,5,22,20,13
2024-25,11/1/2024,202411010CBJ,Columbus Blue Jackets,CBJ,1,WPG,2,3,5,22,20,13,6,7,13,44,17,11
2024-25,11/1/2024,202411010MIN,Tampa Bay Lightning,TBL,0,MIN,3,6,9,30,11,10,5,7,12,22,22,18
2024-25,11/1/2024,202411010MIN,Minnesota Wild,MIN,1,TBL,5,7,12,22,22,18,3,6,9,30,11,10
2024-25,11/1/2024,202411010BUF,New York Islanders,NYI,0,BUF,4,5,9,36,18,23,3,6,9,35,18,9
2024-25,11/1/2024,202411010BUF,Buffalo Sabres,BUF,1,NYI,3,6,9,35,18,9,4,5,9,36,18,23
2024-25,11/1/2024,202411010DAL,Florida Panthers,FLA,0,DAL,6,12,18,28,17,12,4,8,12,36,21,18
2024-25,11/1/2024,202411010DAL,Dallas Stars,DAL,1,FLA,4,8,12,36,21,18,6,12,18,28,17,12
2024-25,10/31/2024,202410310TOR,Seattle Kraken,SEA,0,TOR,1,2,3,25,30,22,4,6,10,30,34,15
2024-25,10/31/2024,202410310PHI,St. Louis Blues,STL,0,PHI,1,2,3,21,24,14,2,4,6,21,10,24
2024-25,10/31/2024,202410310PIT,Anaheim Ducks,ANA,0,PIT,1,2,3,23,27,26,2,3,5,46,17,13
2024-25,10/31/2024,202410310WSH,Montreal Canadiens,MTL,0,WSH,3,5,8,16,23,24,6,10,16,34,22,22
2024-25,10/31/2024,202410310CAR,Boston Bruins,BOS,0,CAR,2,4,6,15,32,13,8,12,20,37,12,7
2024-25,10/31/2024,202410310NSH,Edmonton Oilers,EDM,0,NSH,5,8,13,29,20,19,1,0,1,27,30,11
2024-25,10/31/2024,202410310SJS,Chicago Blackhawks,CHI,0,SJS,2,4,6,28,13,9,3,4,7,29,20,26
2024-25,10/31/2024,202410310TOR,Toronto Maple Leafs,TOR,1,SEA,4,6,10,30,34,15,1,2,3,25,30,22
2024-25,10/31/2024,202410310PHI,Philadelphia Flyers,PHI,1,STL,2,4,6,21,10,24,1,2,3,21,24,14
2024-25,10/31/2024,202410310PIT,Pittsburgh Penguins,PIT,1,ANA,2,3,5,46,17,13,1,2,3,23,27,26
2024-25,10/31/2024,202410310WSH,Washington Capitals,WSH,1,MTL,6,10,16,34,22,22,3,5,8,16,23,24
2024-25,10/31/2024,202410310CAR,Carolina Hurricanes,CAR,1,BOS,8,12,20,37,12,7,2,4,6,15,32,13
2024-25,10/31/2024,202410310NSH,Nashville Predators,NSH,1,EDM,1,0,1,27,30,11,5,8,13,29,20,19
2024-25,10/31/2024,202410310SJS,San Jose Sharks,SJS,1,CHI,3,4,7,29,20,26,2,4,6,28,13,9
2024-25,10/30/2024,202410300CBJ,Columbus Blue Jackets,CBJ,1,NYI,2,4,6,26,18,20,0,0,0,26,23,12
2024-25,10/30/2024,202410300DET,Detroit Red Wings,DET,1,WPG,2,4,6,21,31,6,6,8,14,29,10,17
2024-25,10/30/2024,202410300COL,Colorado Avalanche,COL,1,TBL,2,4,6,35,24,11,5,9,14,21,12,17
2024-25,10/30/2024,202410300UTA,Arizona Coyotes,ARI,1,CGY,5,10,15,28,15,12,1,2,3,31,30,21
2024-25,10/30/2024,202410300VAN,Vancouver Canucks,VAN,1,NJD,0,0,0,20,43,14,6,9,15,22,20,15
2024-25,10/30/2024,202410300LAK,Los Angeles Kings,LAK,1,VEG,6,10,16,27,27,10,3,6,9,26,21,7
2024-25,10/30/2024,202410300CBJ,New York Islanders,NYI,0,CBJ,0,0,0,26,23,12,2,4,6,26,18,20
2024-25,10/30/2024,202410300DET,Winnipeg Jets,WPG,0,DET,6,8,14,29,10,17,2,4,6,21,31,6
2024-25,10/30/2024,202410300COL,Tampa Bay Lightning,TBL,0,COL,5,9,14,21,12,17,2,4,6,35,24,11
2024-25,10/30/2024,202410300UTA,Calgary Flames,CGY,0,ARI,1,2,3,31,30,21,5,10,15,28,15,12
2024-25,10/30/2024,202410300VAN,New Jersey Devils,NJD,0,VAN,6,9,15,22,20,15,0,0,0,20,43,14
2024-25,10/30/2024,202410300LAK,Vegas Golden Knights,VEG,0,LAK,3,6,9,26,21,7,6,10,16,27,27,10
2024-25,10/29/2024,202410290BOS,Boston Bruins,BOS,1,PHI,0,0,0,23,23,11,2,2,4,19,28,28
2024-25,10/29/2024,202410290MTL,Montreal Canadiens,MTL,1,SEA,2,4,6,30,19,13,8,15,23,23,16,17
2024-25,10/29/2024,202410290NYI,Anaheim Ducks,ANA,0,NYI,3,5,8,22,22,25,1,2,3,41,16,14
2024-25,10/29/2024,202410290OTT,Ottawa Senators,OTT,1,STL,8,11,19,35,21,18,1,2,3,27,31,13
2024-25,10/29/2024,202410290PIT,Minnesota Wild,MIN,0,PIT,5,7,12,39,15,16,3,6,9,29,15,11
2024-25,10/29/2024,202410290SJS,Los Angeles Kings,LAK,0,SJS,2,3,5,28,15,11,4,7,11,21,21,24
2024-25,10/29/2024,202410290WSH,New York Rangers,NYR,0,WSH,3,5,8,19,22,13,5,9,14,46,17,10
2024-25,10/29/2024,202410290BOS,Philadelphia Flyers,PHI,0,BOS,2,2,4,19,28,28,0,0,0,23,23,11
2024-25,10/29/2024,202410290MTL,Seattle Kraken,SEA,0,MTL,8,15,23,23,16,17,2,4,6,30,19,13
2024-25,10/29/2024,202410290NYI,New York Islanders,NYI,1,ANA,1,2,3,41,16,14,3,5,8,22,22,25
2024-25,10/29/2024,202410290OTT,St. Louis Blues,STL,0,OTT,1,2,3,27,31,13,8,11,19,35,21,18
2024-25,10/29/2024,202410290PIT,Pittsburgh Penguins,PIT,1,MIN,3,6,9,29,15,11,5,7,12,39,15,16
2024-25,10/29/2024,202410290SJS,San Jose Sharks,SJS,1,LAK,4,7,11,21,21,24,2,3,5,28,15,11
2024-25,10/29/2024,202410290WSH,Washington Capitals,WSH,1,NYR,5,9,14,46,17,10,3,5,8,19,22,13
2024-25,10/28/2024,202410280BUF,Buffalo Sabres,BUF,1,FLA,2,3,5,28,24,14,5,9,14,31,19,11
2024-25,10/28/2024,202410280CBJ,Columbus Blue Jackets,CBJ,1,EDM,6,8,14,25,19,13,1,2,3,32,8,9
2024-25,10/28/2024,202410280COL,Chicago Blackhawks,CHI,0,COL,5,6,11,26,15,17,2,3,5,26,19,13
2024-25,10/28/2024,202410280TBL,Nashville Predators,NSH,0,TBL,2,4,6,37,33,21,3,3,6,27,13,13
2024-25,10/28/2024,202410280UTA,Arizona Coyotes,ARI,1,SJS,4,7,11,23,21,17,5,10,15,45,29,14
2024-25,10/28/2024,202410280VAN,Carolina Hurricanes,CAR,0,VAN,4,8,12,32,23,12,3,6,9,27,28,8
2024-25,10/28/2024,202410280VEG,Calgary Flames,CGY,0,VEG,0,0,0,16,23,23,5,8,13,38,10,23
2024-25,10/28/2024,202410280WPG,Toronto Maple Leafs,TOR,0,WPG,6,10,16,36,25,18,4,8,12,23,21,11
2024-25,10/28/2024,202410280BUF,Florida Panthers,FLA,0,BUF,5,9,14,31,19,11,2,3,5,28,24,14
2024-25,10/28/2024,202410280CBJ,Edmonton Oilers,EDM,0,CBJ,1,2,3,32,8,9,6,8,14,25,19,13
2024-25,10/28/2024,202410280COL,Colorado Avalanche,COL,1,CHI,2,3,5,26,19,13,5,6,11,26,15,17
2024-25,10/28/2024,202410280TBL,Tampa Bay Lightning,TBL,1,NSH,3,3,6,27,13,13,2,4,6,37,33,21
2024-25,10/28/2024,202410280UTA,San Jose Sharks,SJS,0,ARI,5,10,15,45,29,14,4,7,11,23,21,17
2024-25,10/28/2024,202410280VAN,Vancouver Canucks,VAN,1,CAR,3,6,9,27,28,8,4,8,12,32,23,12
2024-25,10/28/2024,202410280VEG,Vegas Golden Knights,VEG,1,CGY,5,8,13,38,10,23,0,0,0,16,23,23
2024-25,10/28/2024,202410280WPG,Winnipeg Jets,WPG,1,TOR,4,8,12,23,21,11,6,10,16,36,25,18
2024-25,10/27/2024,202410270COL,Colorado Avalanche,COL,1,OTT,5,8,13,32,20,8,4,8,12,30,38,23
2024-25,10/27/2024,202410270DET,Detroit Red Wings,DET,1,EDM,2,4,6,26,23,20,3,6,9,34,11,14
2024-25,10/27/2024,202410270NJD,Anaheim Ducks,ANA,0,NJD,2,4,6,26,20,13,6,11,17,34,24,10
2024-25,10/27/2024,202410270PHI,Montreal Canadiens,MTL,0,PHI,4,8,12,24,18,22,3,6,9,26,28,12
2024-25,10/27/2024,202410270COL,Ottawa Senators,OTT,0,COL,4,8,12,30,38,23,5,8,13,32,20,8
2024-25,10/27/2024,202410270DET,Edmonton Oilers,EDM,0,DET,3,6,9,34,11,14,2,4,6,26,23,20
2024-25,10/27/2024,202410270NJD,New Jersey Devils,NJD,1,ANA,6,11,17,34,24,10,2,4,6,26,20,13
2024-25,10/27/2024,202410270PHI,Philadelphia Flyers,PHI,1,MTL,3,6,9,26,28,12,4,8,12,24,18,22
2024-25,10/26/2024,202410260BOS,Boston Bruins,BOS,1,TOR,4,7,11,34,20,19,3,6,9,23,27,18
2024-25,10/26/2024,202410260BUF,Buffalo Sabres,BUF,1,DET,5,7,12,39,14,15,3,4,7,25,12,17
2024-25,10/26/2024,202410260CGY,Calgary Flames,CGY,1,WPG,3,4,7,29,31,18,5,10,15,35,18,17
2024-25,10/26/2024,202410260DAL,Chicago Blackhawks,CHI,0,DAL,2,4,6,24,29,22,4,6,10,30,9,13
2024-25,10/26/2024,202410260LAK,Arizona Coyotes,ARI,0,LAK,2,4,6,25,20,13,3,6,9,23,26,15
2024-25,10/26/2024,202410260MTL,Montreal Canadiens,MTL,1,STL,5,10,15,26,24,19,2,4,6,31,18,16
2024-25,10/26/2024,202410260NSH,Columbus Blue Jackets,CBJ,0,NSH,3,5,8,28,25,15,4,5,9,33,39,14
2024-25,10/26/2024,202410260NYI,Florida Panthers,FLA,0,NYI,6,8,14,28,20,12,3,5,8,28,23,11
2024-25,10/26/2024,202410260NYR,Anaheim Ducks,ANA,0,NYR,1,2,3,33,19,18,2,4,6,32,26,15
2024-25,10/26/2024,202410260PHI,Minnesota Wild,MIN,0,PHI,5,7,12,26,9,12,7,14,21,23,24,22
2024-25,10/26/2024,202410260SEA,Carolina Hurricanes,CAR,0,SEA,4,6,10,39,13,6,1,1,2,19,25,23
2024-25,10/26/2024,202410260TBL,Tampa Bay Lightning,TBL,1,WSH,3,5,8,21,12,19,0,0,0,32,30,16
2024-25,10/26/2024,202410260VAN,Pittsburgh Penguins,PIT,0,VAN,3,6,9,24,16,13,4,6,10,34,24,9
2024-25,10/26/2024,202410260VEG,San Jose Sharks,SJS,0,VEG,3,3,6,26,35,16,7,13,20,42,17,13
2024-25,10/26/2024,202410260BOS,Toronto Maple Leafs,TOR,0,BOS,3,6,9,23,27,18,4,7,11,34,20,19
2024-25,10/26/2024,202410260BUF,Detroit Red Wings,DET,0,BUF,3,4,7,25,12,17,5,7,12,39,14,15
2024-25,10/26/2024,202410260CGY,Winnipeg Jets,WPG,0,CGY,5,10,15,35,18,17,3,4,7,29,31,18
2024-25,10/26/2024,202410260DAL,Dallas Stars,DAL,1,CHI,4,6,10,30,9,13,2,4,6,24,29,22
2024-25,10/26/2024,202410260LAK,Los Angeles Kings,LAK,1,ARI,3,6,9,23,26,15,2,4,6,25,20,13
2024-25,10/26/2024,202410260MTL,St. Louis Blues,STL,0,MTL,2,4,6,31,18,16,5,10,15,26,24,19
2024-25,10/26/2024,202410260NSH,Nashville Predators,NSH,1,CBJ,4,5,9,33,39,14,3,5,8,28,25,15
2024-25,10/26/2024,202410260NYI,New York Islanders,NYI,1,FLA,3,5,8,28,23,11,6,8,14,28,20,12
2024-25,10/26/2024,202410260NYR,New York Rangers,NYR,1,ANA,2,4,6,32,26,15,1,2,3,33,19,18
2024-25,10/26/2024,202410260PHI,Philadelphia Flyers,PHI,1,MIN,7,14,21,23,24,22,5,7,12,26,9,12
2024-25,10/26/2024,202410260SEA,Seattle Kraken,SEA,1,CAR,1,1,2,19,25,23,4,6,10,39,13,6
2024-25,10/26/2024,202410260TBL,Washington Capitals,WSH,0,TBL,0,0,0,32,30,16,3,5,8,21,12,19
2024-25,10/26/2024,202410260VAN,Vancouver Canucks,VAN,1,PIT,4,6,10,34,24,9,3,6,9,24,16,13
2024-25,10/26/2024,202410260VEG,Vegas Golden Knights,VEG,1,SJS,7,13,20,42,17,13,3,3,6,26,35,16
2024-25,10/25/2024,202410250CHI,Chicago Blackhawks,CHI,1,NSH,2,4,6,29,10,16,3,6,9,34,21,16
2024-25,10/25/2024,202410250EDM,Edmonton Oilers,EDM,1,PIT,4,7,11,50,11,17,0,0,0,27,21,19
2024-25,10/25/2024,202410250NJD,New Jersey Devils,NJD,1,NYI,3,4,7,35,27,11,4,8,12,30,32,15
2024-25,10/25/2024,202410250VEG,Ottawa Senators,OTT,0,VEG,4,6,10,39,28,20,6,11,17,28,32,12
2024-25,10/25/2024,202410250CHI,Nashville Predators,NSH,0,CHI,3,6,9,34,21,16,2,4,6,29,10,16
2024-25,10/25/2024,202410250EDM,Pittsburgh Penguins,PIT,0,EDM,0,0,0,27,21,19,4,7,11,50,11,17
2024-25,10/25/2024,202410250NJD,New York Islanders,NYI,0,NJD,4,8,12,30,32,15,3,4,7,35,27,11
2024-25,10/25/2024,202410250VEG,Vegas Golden Knights,VEG,1,OTT,6,11,17,28,32,12,4,6,10,39,28,20
2024-25,10/24/2024,202410240BOS,Boston Bruins,BOS,1,DAL,2,3,5,27,29,14,5,9,14,32,18,9
2024-25,10/24/2024,202410240CGY,Carolina Hurricanes,CAR,0,CGY,4,6,10,43,17,15,2,4,6,32,31,19
2024-25,10/24/2024,202410240DET,Detroit Red Wings,DET,1,NJD,5,6,11,20,24,16,3,5,8,40,37,14
2024-25,10/24/2024,202410240LAK,Los Angeles Kings,LAK,1,SJS,3,5,8,30,24,24,2,4,6,26,39,13
2024-25,10/24/2024,202410240NYR,Florida Panthers,FLA,0,NYR,3,5,8,29,32,13,1,2,3,25,29,13
2024-25,10/24/2024,202410240SEA,Seattle Kraken,SEA,1,WPG,3,4,7,32,34,16,4,8,12,36,31,15
2024-25,10/24/2024,202410240TBL,Minnesota Wild,MIN,0,TBL,4,8,12,18,29,19,2,4,6,26,14,16
2024-25,10/24/2024,202410240TOR,St. Louis Blues,STL,0,TOR,5,7,12,27,24,23,1,2,3,41,21,8
2024-25,10/24/2024,202410240UTA,Arizona Coyotes,ARI,1,COL,1,2,3,26,15,10,5,8,13,26,27,19
2024-25,10/24/2024,202410240BOS,Dallas Stars,DAL,0,BOS,5,9,14,32,18,9,2,3,5,27,29,14
2024-25,10/24/2024,202410240CGY,Calgary Flames,CGY,1,CAR,2,4,6,32,31,19,4,6,10,43,17,15
2024-25,10/24/2024,202410240DET,New Jersey Devils,NJD,0,DET,3,5,8,40,37,14,5,6,11,20,24,16
2024-25,10/24/2024,202410240LAK,San Jose Sharks,SJS,0,LAK,2,4,6,26,39,13,3,5,8,30,24,24
2024-25,10/24/2024,202410240NYR,New York Rangers,NYR,1,FLA,1,2,3,25,29,13,3,5,8,29,32,13
2024-25,10/24/2024,202410240SEA,Winnipeg Jets,WPG,0,SEA,4,8,12,36,31,15,3,4,7,32,34,16
2024-25,10/24/2024,202410240TBL,Tampa Bay Lightning,TBL,1,MIN,2,4,6,26,14,16,4,8,12,18,29,19
2024-25,10/24/2024,202410240TOR,Toronto Maple Leafs,TOR,1,STL,1,2,3,41,21,8,5,7,12,27,24,23
2024-25,10/24/2024,202410240UTA,Colorado Avalanche,COL,0,ARI,5,8,13,26,27,19,1,2,3,26,15,10
2024-25,10/23/2024,202410230WSH,Philadelphia Flyers,PHI,0,WSH,3,6,9,29,32,11,6,9,15,25,16,20
2024-25,10/23/2024,202410230WSH,Washington Capitals,WSH,1,PHI,6,9,15,25,16,20,3,6,9,29,32,11
2024-25,10/22/2024,202410220ANA,Anaheim Ducks,ANA,1,SJS,3,4,7,40,15,25,1,2,3,28,22,15
2024-25,10/22/2024,202410220BUF,Buffalo Sabres,BUF,1,DAL,4,7,11,25,17,27,2,4,6,30,20,16
2024-25,10/22/2024,202410220CBJ,Columbus Blue Jackets,CBJ,1,TOR,6,11,17,38,19,14,2,2,4,28,22,15
2024-25,10/22/2024,202410220CGY,Calgary Flames,CGY,1,PIT,3,6,9,25,24,11,3,6,9,38,31,21
2024-25,10/22/2024,202410220CHI,Chicago Blackhawks,CHI,1,VAN,3,5,8,34,16,14,6,12,18,30,25,12
2024-25,10/22/2024,202410220EDM,Carolina Hurricanes,CAR,0,EDM,3,6,9,33,25,13,2,3,5,35,14,15
2024-25,10/22/2024,202410220FLA,Florida Panthers,FLA,1,MIN,1,2,3,25,55,12,5,9,14,22,26,20
2024-25,10/22/2024,202410220MTL,Montreal Canadiens,MTL,1,NYR,2,4,6,23,21,16,7,12,19,45,18,15
2024-25,10/22/2024,202410220NJD,New Jersey Devils,NJD,1,TBL,5,8,13,35,23,9,8,14,22,37,13,20
2024-25,10/22/2024,202410220NSH,Boston Bruins,BOS,0,NSH,0,0,0,33,17,18,4,6,10,42,32,10
2024-25,10/22/2024,202410220NYI,Detroit Red Wings,DET,0,NYI,1,2,3,11,10,15,0,0,0,29,13,9
2024-25,10/22/2024,202410220PHI,Philadelphia Flyers,PHI,1,WSH,1,2,3,18,23,12,4,6,10,29,20,16
2024-25,10/22/2024,202410220SEA,Colorado Avalanche,COL,0,SEA,3,5,8,28,17,23,2,2,4,27,18,17
2024-25,10/22/2024,202410220STL,St. Louis Blues,STL,1,WPG,2,4,6,29,22,21,3,6,9,24,14,16
2024-25,10/22/2024,202410220VEG,Los Angeles Kings,LAK,0,VEG,1,2,3,33,35,12,6,11,17,30,21,21
2024-25,10/22/2024,202410220UTA,Arizona Coyotes,ARI,1,OTT,0,0,0,31,29,12,4,5,9,23,38,16
2024-25,10/22/2024,202410220ANA,San Jose Sharks,SJS,0,ANA,1,2,3,28,22,15,3,4,7,40,15,25
2024-25,10/22/2024,202410220BUF,Dallas Stars,DAL,0,BUF,2,4,6,30,20,16,4,7,11,25,17,27
2024-25,10/22/2024,202410220CBJ,Toronto Maple Leafs,TOR,0,CBJ,2,2,4,28,22,15,6,11,17,38,19,14
2024-25,10/22/2024,202410220CGY,Pittsburgh Penguins,PIT,0,CGY,3,6,9,38,31,21,3,6,9,25,24,11
2024-25,10/22/2024,202410220CHI,Vancouver Canucks,VAN,0,CHI,6,12,18,30,25,12,3,5,8,34,16,14
2024-25,10/22/2024,202410220EDM,Edmonton Oilers,EDM,1,CAR,2,3,5,35,14,15,3,6,9,33,25,13
2024-25,10/22/2024,202410220FLA,Minnesota Wild,MIN,0,FLA,5,9,14,22,26,20,1,2,3,25,55,12
2024-25,10/22/2024,202410220MTL,New York Rangers,NYR,0,MTL,7,12,19,45,18,15,2,4,6,23,21,16
2024-25,10/22/2024,202410220NJD,Tampa Bay Lightning,TBL,0,NJD,8,14,22,37,13,20,5,8,13,35,23,9
2024-25,10/22/2024,202410220NSH,Nashville Predators,NSH,1,BOS,4,6,10,42,32,10,0,0,0,33,17,18
2024-25,10/22/2024,202410220NYI,New York Islanders,NYI,1,DET,0,0,0,29,13,9,1,2,3,11,10,15
2024-25,10/22/2024,202410220PHI,Washington Capitals,WSH,0,PHI,4,6,10,29,20,16,1,2,3,18,23,12
2024-25,10/22/2024,202410220SEA,Seattle Kraken,SEA,1,COL,2,2,4,27,18,17,3,5,8,28,17,23
2024-25,10/22/2024,202410220STL,Winnipeg Jets,WPG,0,STL,3,6,9,24,14,16,2,4,6,29,22,21
2024-25,10/22/2024,202410220VEG,Vegas Golden Knights,VEG,1,LAK,6,11,17,30,21,21,1,2,3,33,35,12
2024-25,10/22/2024,202410220UTA,Ottawa Senators,OTT,0,ARI,4,5,9,23,38,16,0,0,0,31,29,12
2024-25,10/21/2024,202410210TOR,Tampa Bay Lightning,TBL,0,TOR,2,4,6,34,20,14,5,7,12,29,20,18
2024-25,10/21/2024,202410210TOR,Toronto Maple Leafs,TOR,1,TBL,5,7,12,29,20,18,2,4,6,34,20,14
2024-25,10/20/2024,202410200ANA,Anaheim Ducks,ANA,1,LAK,1,2,3,15,20,17,4,5,9,37,20,11
2024-25,10/20/2024,202410200SJS,Colorado Avalanche,COL,0,SJS,4,8,12,22,19,18,1,2,3,26,26,13
2024-25,10/20/2024,202410200WPG,Pittsburgh Penguins,PIT,0,WPG,3,4,7,42,18,11,6,10,16,37,21,25
2024-25,10/20/2024,202410200ANA,Los Angeles Kings,LAK,0,ANA,4,5,9,37,20,11,1,2,3,15,20,17
2024-25,10/20/2024,202410200SJS,San Jose Sharks,SJS,1,COL,1,2,3,26,26,13,4,8,12,22,19,18
2024-25,10/20/2024,202410200WPG,Winnipeg Jets,WPG,1,PIT,6,10,16,37,21,25,3,4,7,42,18,11
2024-25,10/19/2024,202410190CBJ,Columbus Blue Jackets,CBJ,1,MIN,1,2,3,24,27,11,3,6,9,35,13,20
2024-25,10/19/2024,202410190CHI,Buffalo Sabres,BUF,0,CHI,4,7,11,22,24,14,2,4,6,37,21,19
2024-25,10/19/2024,202410190DAL,Dallas Stars,DAL,1,EDM,4,7,11,24,23,22,1,2,3,31,10,12
2024-25,10/19/2024,202410190FLA,Florida Panthers,FLA,1,VEG,4,8,12,49,17,17,3,3,6,26,25,28
2024-25,10/19/2024,202410190NJD,New Jersey Devils,NJD,1,WSH,5,8,13,31,32,15,6,10,16,37,40,15
2024-25,10/19/2024,202410190NSH,Detroit Red Wings,DET,0,NSH,5,7,12,24,25,16,2,4,6,39,27,12
2024-25,10/19/2024,202410190NYI,Montreal Canadiens,MTL,0,NYI,3,6,9,24,30,25,3,6,9,36,28,8
2024-25,10/19/2024,202410190OTT,Ottawa Senators,OTT,1,TBL,5,8,13,28,30,18,4,8,12,29,15,20
2024-25,10/19/2024,202410190PHI,Philadelphia Flyers,PHI,1,VAN,0,0,0,26,28,12,3,5,8,32,37,10
2024-25,10/19/2024,202410190SEA,Calgary Flames,CGY,0,SEA,1,1,2,22,31,16,2,3,5,23,27,10
2024-25,10/19/2024,202410190STL,Carolina Hurricanes,CAR,0,STL,3,6,9,40,13,5,4,7,11,19,27,12
2024-25,10/19/2024,202410190TOR,New York Rangers,NYR,0,TOR,4,8,12,29,19,22,1,2,3,35,20,11
2024-25,10/19/2024,202410190UTA,Arizona Coyotes,ARI,1,BOS,2,4,6,32,12,8,1,1,2,23,29,19
2024-25,10/19/2024,202410190CBJ,Minnesota Wild,MIN,0,CBJ,3,6,9,35,13,20,1,2,3,24,27,11
2024-25,10/19/2024,202410190CHI,Chicago Blackhawks,CHI,1,BUF,2,4,6,37,21,19,4,7,11,22,24,14
2024-25,10/19/2024,202410190DAL,Edmonton Oilers,EDM,0,DAL,1,2,3,31,10,12,4,7,11,24,23,22
2024-25,10/19/2024,202410190FLA,Vegas Golden Knights,VEG,0,FLA,3,3,6,26,25,28,4,8,12,49,17,17
2024-25,10/19/2024,202410190NJD,Washington Capitals,WSH,0,NJD,6,10,16,37,40,15,5,8,13,31,32,15
2024-25,10/19/2024,202410190NSH,Nashville Predators,NSH,1,DET,2,4,6,39,27,12,5,7,12,24,25,16
2024-25,10/19/2024,202410190NYI,New York Islanders,NYI,1,MTL,3,6,9,36,28,8,3,6,9,24,30,25
2024-25,10/19/2024,202410190OTT,Tampa Bay Lightning,TBL,0,OTT,4,8,12,29,15,20,5,8,13,28,30,18
2024-25,10/19/2024,202410190PHI,Vancouver Canucks,VAN,0,PHI,3,5,8,32,37,10,0,0,0,26,28,12
2024-25,10/19/2024,202410190SEA,Seattle Kraken,SEA,1,CGY,2,3,5,23,27,10,1,1,2,22,31,16
2024-25,10/19/2024,202410190STL,St. Louis Blues,STL,1,CAR,4,7,11,19,27,12,3,6,9,40,13,5
2024-25,10/19/2024,202410190TOR,Toronto Maple Leafs,TOR,1,NYR,1,2,3,35,20,11,4,8,12,29,19,22
2024-25,10/19/2024,202410190UTA,Boston Bruins,BOS,0,ARI,1,1,2,23,29,19,2,4,6,32,12,8
2024-25,10/18/2024,202410180COL,Anaheim Ducks,ANA,0,COL,3,2,5,20,21,27,4,7,11,49,16,19
2024-25,10/18/2024,202410180PIT,Carolina Hurricanes,CAR,0,PIT,4,8,12,39,15,13,1,2,3,26,27,21
2024-25,10/18/2024,202410180WPG,San Jose Sharks,SJS,0,WPG,3,6,9,22,25,21,8,15,23,36,20,10
2024-25,10/18/2024,202410180COL,Colorado Avalanche,COL,1,ANA,4,7,11,49,16,19,3,2,5,20,21,27
2024-25,10/18/2024,202410180PIT,Pittsburgh Penguins,PIT,1,CAR,1,2,3,26,27,21,4,8,12,39,15,13
2024-25,10/18/2024,202410180WPG,Winnipeg Jets,WPG,1,SJS,8,15,23,36,20,10,3,6,9,22,25,21
2024-25,10/17/2024,202410170CBJ,Buffalo Sabres,BUF,0,CBJ,4,6,10,24,9,8,6,9,15,25,6,17
2024-25,10/17/2024,202410170CHI,Chicago Blackhawks,CHI,1,SJS,4,6,10,27,13,18,2,4,6,22,22,18
2024-25,10/17/2024,202410170DET,Detroit Red Wings,DET,1,NYR,2,4,6,31,20,16,5,10,15,34,14,11
2024-25,10/17/2024,202410170FLA,Florida Panthers,FLA,1,VAN,2,4,6,28,35,10,3,6,9,33,41,18
2024-25,10/17/2024,202410170MTL,Los Angeles Kings,LAK,0,MTL,4,7,11,32,25,12,1,2,3,27,34,19
2024-25,10/17/2024,202410170NSH,Edmonton Oilers,EDM,0,NSH,4,4,8,36,8,18,2,3,5,27,30,15
2024-25,10/17/2024,202410170OTT,New Jersey Devils,NJD,0,OTT,3,4,7,35,22,11,1,2,3,31,27,18
2024-25,10/17/2024,202410170SEA,Philadelphia Flyers,PHI,0,SEA,4,7,11,25,27,21,6,12,18,29,21,19
2024-25,10/17/2024,202410170STL,New York Islanders,NYI,0,STL,0,0,0,34,23,21,1,1,2,30,30,12
2024-25,10/17/2024,202410170TBL,Tampa Bay Lightning,TBL,1,VEG,4,7,11,25,22,9,3,5,8,25,16,20
2024-25,10/17/2024,202410170WSH,Dallas Stars,DAL,0,WSH,2,3,5,24,9,12,3,4,7,26,27,26
2024-25,10/17/2024,202410170CBJ,Columbus Blue Jackets,CBJ,1,BUF,6,9,15,25,6,17,4,6,10,24,9,8
2024-25,10/17/2024,202410170CHI,San Jose Sharks,SJS,0,CHI,2,4,6,22,22,18,4,6,10,27,13,18
2024-25,10/17/2024,202410170DET,New York Rangers,NYR,0,DET,5,10,15,34,14,11,2,4,6,31,20,16
2024-25,10/17/2024,202410170FLA,Vancouver Canucks,VAN,0,FLA,3,6,9,33,41,18,2,4,6,28,35,10
2024-25,10/17/2024,202410170MTL,Montreal Canadiens,MTL,1,LAK,1,2,3,27,34,19,4,7,11,32,25,12
2024-25,10/17/2024,202410170NSH,Nashville Predators,NSH,1,EDM,2,3,5,27,30,15,4,4,8,36,8,18
2024-25,10/17/2024,202410170OTT,Ottawa Senators,OTT,1,NJD,1,2,3,31,27,18,3,4,7,35,22,11
2024-25,10/17/2024,202410170SEA,Seattle Kraken,SEA,1,PHI,6,12,18,29,21,19,4,7,11,25,27,21
2024-25,10/17/2024,202410170STL,St. Louis Blues,STL,1,NYI,1,1,2,30,30,12,0,0,0,34,23,21
2024-25,10/17/2024,202410170TBL,Vegas Golden Knights,VEG,0,TBL,3,5,8,25,16,20,4,7,11,25,22,9
2024-25,10/17/2024,202410170WSH,Washington Capitals,WSH,1,DAL,3,4,7,26,27,26,2,3,5,24,9,12
2024-25,10/16/2024,202410160ANA,Anaheim Ducks,ANA,1,ARI,5,8,13,34,18,19,4,7,11,30,9,20
2024-25,10/16/2024,202410160COL,Boston Bruins,BOS,0,COL,5,5,10,25,34,14,3,6,9,25,34,15
2024-25,10/16/2024,202410160PIT,Buffalo Sabres,BUF,0,PIT,5,7,12,33,19,17,6,10,16,43,16,14
2024-25,10/16/2024,202410160TOR,Los Angeles Kings,LAK,0,TOR,2,3,5,34,27,8,6,12,18,26,28,17
2024-25,10/16/2024,202410160ANA,Arizona Coyotes,ARI,0,ANA,4,7,11,30,9,20,5,8,13,34,18,19
2024-25,10/16/2024,202410160COL,Colorado Avalanche,COL,1,BOS,3,6,9,25,34,15,5,5,10,25,34,14
2024-25,10/16/2024,202410160PIT,Pittsburgh Penguins,PIT,1,BUF,6,10,16,43,16,14,5,7,12,33,19,17
2024-25,10/16/2024,202410160TOR,Toronto Maple Leafs,TOR,1,LAK,6,12,18,26,28,17,2,3,5,34,27,8
2024-25,10/15/2024,202410150CAR,Carolina Hurricanes,CAR,1,NJD,4,6,10,31,19,16,2,4,6,25,25,25
2024-25,10/15/2024,202410150CBJ,Columbus Blue Jackets,CBJ,1,FLA,3,5,8,38,17,13,4,8,12,22,25,13
2024-25,10/15/2024,202410150CGY,Calgary Flames,CGY,1,CHI,3,5,8,26,28,21,1,2,3,32,13,18
2024-25,10/15/2024,202410150DAL,Dallas Stars,DAL,1,SJS,2,4,6,38,19,10,2,1,3,27,33,18
2024-25,10/15/2024,202410150EDM,Edmonton Oilers,EDM,1,PHI,4,7,11,33,23,9,3,6,9,30,21,21
2024-25,10/15/2024,202410150NSH,Nashville Predators,NSH,1,SEA,3,6,9,33,28,8,7,11,18,35,23,19
2024-25,10/15/2024,202410150STL,Minnesota Wild,MIN,0,STL,3,6,9,26,30,23,1,2,3,28,29,18
2024-25,10/15/2024,202410150TBL,Tampa Bay Lightning,TBL,1,VAN,4,8,12,28,13,19,1,2,3,27,22,15
2024-25,10/15/2024,202410150WSH,Vegas Golden Knights,VEG,0,WSH,2,4,6,26,9,15,4,6,10,22,24,13
2024-25,10/15/2024,202410150CAR,New Jersey Devils,NJD,0,CAR,2,4,6,25,25,25,4,6,10,31,19,16
2024-25,10/15/2024,202410150CBJ,Florida Panthers,FLA,0,CBJ,4,8,12,22,25,13,3,5,8,38,17,13
2024-25,10/15/2024,202410150CGY,Chicago Blackhawks,CHI,0,CGY,1,2,3,32,13,18,3,5,8,26,28,21
2024-25,10/15/2024,202410150DAL,San Jose Sharks,SJS,0,DAL,2,1,3,27,33,18,2,4,6,38,19,10
2024-25,10/15/2024,202410150EDM,Philadelphia Flyers,PHI,0,EDM,3,6,9,30,21,21,4,7,11,33,23,9
2024-25,10/15/2024,202410150NSH,Seattle Kraken,SEA,0,NSH,7,11,18,35,23,19,3,6,9,33,28,8
2024-25,10/15/2024,202410150STL,St. Louis Blues,STL,1,MIN,1,2,3,28,29,18,3,6,9,26,30,23
2024-25,10/15/2024,202410150TBL,Vancouver Canucks,VAN,0,TBL,1,2,3,27,22,15,4,8,12,28,13,19
2024-25,10/15/2024,202410150WSH,Washington Capitals,WSH,1,VEG,4,6,10,22,24,13,2,4,6,26,9,15
2024-25,10/14/2024,202410140BOS,Boston Bruins,BOS,1,FLA,3,6,9,27,39,8,4,2,6,26,35,7
2024-25,10/14/2024,202410140COL,Colorado Avalanche,COL,1,NYI,2,3,5,34,22,14,6,7,13,38,13,21
2024-25,10/14/2024,202410140MTL,Montreal Canadiens,MTL,1,PIT,3,4,7,27,27,22,6,9,15,31,23,15
2024-25,10/14/2024,202410140NJD,Arizona Coyotes,ARI,0,NJD,0,0,0,20,8,21,3,4,7,33,28,9
2024-25,10/14/2024,202410140NYR,Detroit Red Wings,DET,0,NYR,1,2,3,32,19,17,4,7,11,28,19,10
2024-25,10/14/2024,202410140OTT,Los Angeles Kings,LAK,0,OTT,7,10,17,26,22,22,8,14,22,41,25,10
2024-25,10/14/2024,202410140BOS,Florida Panthers,FLA,0,BOS,4,2,6,26,35,7,3,6,9,27,39,8
2024-25,10/14/2024,202410140COL,New York Islanders,NYI,0,COL,6,7,13,38,13,21,2,3,5,34,22,14
2024-25,10/14/2024,202410140MTL,Pittsburgh Penguins,PIT,0,MTL,6,9,15,31,23,15,3,4,7,27,27,22
2024-25,10/14/2024,202410140NJD,New Jersey Devils,NJD,1,ARI,3,4,7,33,28,9,0,0,0,20,8,21
2024-25,10/14/2024,202410140NYR,New York Rangers,NYR,1,DET,4,7,11,28,19,10,1,2,3,32,19,17
2024-25,10/14/2024,202410140OTT,Ottawa Senators,OTT,1,LAK,8,14,22,41,25,10,7,10,17,26,22,22
2024-25,10/13/2024,202410130DAL,Dallas Stars,DAL,1,SEA,2,4,6,23,13,14,0,0,0,25,24,16
2024-25,10/13/2024,202410130EDM,Calgary Flames,CGY,0,EDM,4,4,8,29,27,17,1,2,3,26,13,17
2024-25,10/13/2024,202410130VEG,Anaheim Ducks,ANA,0,VEG,1,0,1,23,20,15,3,5,8,32,15,18
2024-25,10/13/2024,202410130WPG,Minnesota Wild,MIN,0,WPG,1,1,2,27,14,15,2,3,5,35,16,11
2024-25,10/13/2024,202410130DAL,Seattle Kraken,SEA,0,DAL,0,0,0,25,24,16,2,4,6,23,13,14
2024-25,10/13/2024,202410130EDM,Edmonton Oilers,EDM,1,CGY,1,2,3,26,13,17,4,4,8,29,27,17
2024-25,10/13/2024,202410130VEG,Vegas Golden Knights,VEG,1,ANA,3,5,8,32,15,18,1,0,1,23,20,15
2024-25,10/13/2024,202410130WPG,Winnipeg Jets,WPG,1,MIN,2,3,5,35,16,11,1,1,2,27,14,15
2024-25,10/12/2024,202410120BOS,Boston Bruins,BOS,1,LAK,2,3,5,25,29,19,1,2,3,34,24,15
2024-25,10/12/2024,202410120BUF,Buffalo Sabres,BUF,1,FLA,5,7,12,27,24,16,2,4,6,25,24,14
2024-25,10/12/2024,202410120CGY,Calgary Flames,CGY,1,PHI,6,12,18,32,29,15,3,6,9,40,27,17
2024-25,10/12/2024,202410120COL,Columbus Blue Jackets,CBJ,0,COL,6,9,15,23,7,19,4,8,12,30,26,13
2024-25,10/12/2024,202410120DAL,Dallas Stars,DAL,1,NYI,3,5,8,27,18,14,0,0,0,34,17,13
2024-25,10/12/2024,202410120DET,Detroit Red Wings,DET,1,NSH,3,4,7,22,22,31,0,0,0,42,19,12
2024-25,10/12/2024,202410120EDM,Chicago Blackhawks,CHI,0,EDM,5,10,15,20,15,35,2,4,6,38,9,12
2024-25,10/12/2024,202410120MIN,Minnesota Wild,MIN,1,SEA,4,8,12,38,32,8,4,8,12,34,20,15
2024-25,10/12/2024,202410120MTL,Montreal Canadiens,MTL,1,OTT,4,8,12,26,17,22,1,2,3,25,17,11
2024-25,10/12/2024,202410120NYR,Arizona Coyotes,ARI,0,NYR,6,8,14,26,11,15,5,8,13,34,17,13
2024-25,10/12/2024,202410120SJS,Anaheim Ducks,ANA,0,SJS,2,3,5,30,11,18,0,0,0,30,13,10
2024-25,10/12/2024,202410120TOR,Pittsburgh Penguins,PIT,0,TOR,2,3,5,23,13,10,4,4,8,33,17,17
2024-25,10/12/2024,202410120WSH,New Jersey Devils,NJD,0,WSH,5,10,15,33,18,15,3,5,8,32,20,18
2024-25,10/12/2024,202410120BOS,Los Angeles Kings,LAK,0,BOS,1,2,3,34,24,15,2,3,5,25,29,19
2024-25,10/12/2024,202410120BUF,Florida Panthers,FLA,0,BUF,2,4,6,25,24,14,5,7,12,27,24,16
2024-25,10/12/2024,202410120CGY,Philadelphia Flyers,PHI,0,CGY,3,6,9,40,27,17,6,12,18,32,29,15
2024-25,10/12/2024,202410120COL,Colorado Avalanche,COL,1,CBJ,4,8,12,30,26,13,6,9,15,23,7,19
2024-25,10/12/2024,202410120DAL,New York Islanders,NYI,0,DAL,0,0,0,34,17,13,3,5,8,27,18,14
2024-25,10/12/2024,202410120DET,Nashville Predators,NSH,0,DET,0,0,0,42,19,12,3,4,7,22,22,31
2024-25,10/12/2024,202410120EDM,Edmonton Oilers,EDM,1,CHI,2,4,6,38,9,12,5,10,15,20,15,35
2024-25,10/12/2024,202410120MIN,Seattle Kraken,SEA,0,MIN,4,8,12,34,20,15,4,8,12,38,32,8
2024-25,10/12/2024,202410120MTL,Ottawa Senators,OTT,0,MTL,1,2,3,25,17,11,4,8,12,26,17,22
2024-25,10/12/2024,202410120NYR,New York Rangers,NYR,1,ARI,5,8,13,34,17,13,6,8,14,26,11,15
2024-25,10/12/2024,202410120SJS,San Jose Sharks,SJS,1,ANA,0,0,0,30,13,10,2,3,5,30,11,18
2024-25,10/12/2024,202410120TOR,Toronto Maple Leafs,TOR,1,PIT,4,4,8,33,17,17,2,3,5,23,13,10
2024-25,10/12/2024,202410120WSH,Washington Capitals,WSH,1,NJD,3,5,8,32,20,18,5,10,15,33,18,15
2024-25,10/11/2024,202410110CAR,Carolina Hurricanes,CAR,1,TBL,1,1,2,21,17,11,4,8,12,23,19,19
2024-25,10/11/2024,202410110VAN,Philadelphia Flyers,PHI,0,VAN,2,4,6,31,21,20,2,3,5,26,25,12
2024-25,10/11/2024,202410110VEG,St. Louis Blues,STL,0,VEG,3,6,9,22,18,11,4,7,11,28,10,15
2024-25,10/11/2024,202410110WPG,Chicago Blackhawks,CHI,0,WPG,1,1,2,26,17,16,2,3,5,35,13,10
2024-25,10/11/2024,202410110CAR,Tampa Bay Lightning,TBL,0,CAR,4,8,12,23,19,19,1,1,2,21,17,11
2024-25,10/11/2024,202410110VAN,Vancouver Canucks,VAN,1,PHI,2,3,5,26,25,12,2,4,6,31,21,20
2024-25,10/11/2024,202410110VEG,Vegas Golden Knights,VEG,1,STL,4,7,11,28,10,15,3,6,9,22,18,11
2024-25,10/11/2024,202410110WPG,Winnipeg Jets,WPG,1,CHI,2,3,5,35,13,10,1,1,2,26,17,16
2024-25,10/10/2024,202410100BOS,Boston Bruins,BOS,1,MTL,6,12,18,29,20,15,4,8,12,24,19,16
2024-25,10/10/2024,202410100BUF,Buffalo Sabres,BUF,1,LAK,1,0,1,33,28,14,3,6,9,23,16,19
2024-25,10/10/2024,202410100DET,Detroit Red Wings,DET,1,PIT,3,6,9,32,19,12,6,9,15,28,20,16
2024-25,10/10/2024,202410100MIN,Columbus Blue Jackets,CBJ,0,MIN,2,4,6,33,20,8,3,6,9,26,14,18
2024-25,10/10/2024,202410100NJD,New Jersey Devils,NJD,1,TOR,2,2,4,24,31,11,4,7,11,22,11,27
2024-25,10/10/2024,202410100NSH,Dallas Stars,DAL,0,NSH,4,8,12,20,10,13,3,5,8,36,14,16
2024-25,10/10/2024,202410100NYI,Arizona Coyotes,ARI,0,NYI,5,10,15,26,13,20,4,7,11,25,20,20
2024-25,10/10/2024,202410100OTT,Florida Panthers,FLA,0,OTT,1,2,3,31,20,9,3,3,6,31,27,30
2024-25,10/10/2024,202410100SJS,San Jose Sharks,SJS,1,STL,4,6,10,29,19,23,5,8,13,40,13,15
2024-25,10/10/2024,202410100BOS,Montreal Canadiens,MTL,0,BOS,4,8,12,24,19,16,6,12,18,29,20,15
2024-25,10/10/2024,202410100BUF,Los Angeles Kings,LAK,0,BUF,3,6,9,23,16,19,1,0,1,33,28,14
2024-25,10/10/2024,202410100DET,Pittsburgh Penguins,PIT,0,DET,6,9,15,28,20,16,3,6,9,32,19,12
2024-25,10/10/2024,202410100MIN,Minnesota Wild,MIN,1,CBJ,3,6,9,26,14,18,2,4,6,33,20,8
2024-25,10/10/2024,202410100NJD,Toronto Maple Leafs,TOR,0,NJD,4,7,11,22,11,27,2,2,4,24,31,11
2024-25,10/10/2024,202410100NSH,Nashville Predators,NSH,1,DAL,3,5,8,36,14,16,4,8,12,20,10,13
2024-25,10/10/2024,202410100NYI,New York Islanders,NYI,1,ARI,4,7,11,25,20,20,5,10,15,26,13,20
2024-25,10/10/2024,202410100OTT,Ottawa Senators,OTT,1,FLA,3,3,6,31,27,30,1,2,3,31,20,9
2024-25,10/10/2024,202410100SJS,St. Louis Blues,STL,0,SJS,5,8,13,40,13,15,4,6,10,29,19,23
2024-25,10/9/2024,202410090EDM,Edmonton Oilers,EDM,1,WPG,0,0,0,30,15,8,6,12,18,20,9,29
2024-25,10/9/2024,202410090MTL,Montreal Canadiens,MTL,1,TOR,1,2,3,27,20,25,0,0,0,48,20,15
2024-25,10/9/2024,202410090PIT,New York Rangers,NYR,0,PIT,6,8,14,41,16,20,0,0,0,29,23,10
2024-25,10/9/2024,202410090VAN,Calgary Flames,CGY,0,VAN,6,10,16,26,18,21,5,9,14,25,13,12
2024-25,10/9/2024,202410090VEG,Colorado Avalanche,COL,0,VEG,4,8,12,32,19,9,8,15,23,21,15,18
2024-25,10/9/2024,202410090EDM,Winnipeg Jets,WPG,0,EDM,6,12,18,20,9,29,0,0,0,30,15,8
2024-25,10/9/2024,202410090MTL,Toronto Maple Leafs,TOR,0,MTL,0,0,0,48,20,15,1,2,3,27,20,25
2024-25,10/9/2024,202410090PIT,Pittsburgh Penguins,PIT,1,NYR,0,0,0,29,23,10,6,8,14,41,16,20
2024-25,10/9/2024,202410090VAN,Vancouver Canucks,VAN,1,CGY,5,9,14,25,13,12,6,10,16,26,18,21
2024-25,10/9/2024,202410090VEG,Vegas Golden Knights,VEG,1,COL,8,15,23,21,15,18,4,8,12,32,19,9
2024-25,10/8/2024,202410080FLA,Boston Bruins,BOS,0,FLA,4,6,10,28,26,21,6,9,15,35,21,8
2024-25,10/8/2024,202410080SEA,Seattle Kraken,SEA,1,STL,2,3,5,32,20,16,3,5,8,25,28,18
2024-25,10/8/2024,202410080UTA,Arizona Coyotes,ARI,1,CHI,5,9,14,25,20,23,2,4,6,26,24,12
2024-25,10/8/2024,202410080FLA,Florida Panthers,FLA,1,BOS,6,9,15,35,21,8,4,6,10,28,26,21
2024-25,10/8/2024,202410080SEA,St. Louis Blues,STL,0,SEA,3,5,8,25,28,18,2,3,5,32,20,16
2024-25,10/8/2024,202410080UTA,Chicago Blackhawks,CHI,0,ARI,2,4,6,26,24,12,5,9,14,25,20,23
2024-25,10/5/2024,202410050NJD,Buffalo Sabres,BUF,0,NJD,1,2,3,18,25,10,3,5,8,36,13,22
2024-25,10/5/2024,202410050NJD,New Jersey Devils,NJD,1,BUF,3,5,8,36,13,22,1,2,3,18,25,10
2024-25,10/4/2024,202410040BUF,Buffalo Sabres,BUF,1,NJD,1,2,3,31,25,15,4,6,10,23,25,17
2024-25,10/4/2024,202410040BUF,New Jersey Devils,NJD,0,BUF,4,6,10,23,25,17,1,2,3,31,25,15
2023-24,4/18/2024,202404180CGY,Calgary Flames,CGY,1,SJS,5,8,13,37,17,14,1,2,3,17,10,16
2023-24,4/18/2024,202404180COL,Colorado Avalanche,COL,1,EDM,5,10,15,27,11,12,1,2,3,26,17,16
2023-24,4/18/2024,202404180LAK,Chicago Blackhawks,CHI,0,LAK,4,4,8,13,21,13,5,8,13,35,13,7
2023-24,4/18/2024,202404180MIN,Minnesota Wild,MIN,1,SEA,3,4,7,24,9,16,4,7,11,27,10,15
2023-24,4/18/2024,202404180VEG,Anaheim Ducks,ANA,0,VEG,4,7,11,23,17,20,1,2,3,33,23,15
2023-24,4/18/2024,202404180WPG,Vancouver Canucks,VAN,0,WPG,2,2,4,20,32,11,4,5,9,26,23,19
2023-24,4/18/2024,202404180CGY,San Jose Sharks,SJS,0,CGY,1,2,3,17,10,16,5,8,13,37,17,14
2023-24,4/18/2024,202404180COL,Edmonton Oilers,EDM,0,COL,1,2,3,26,17,16,5,10,15,27,11,12
2023-24,4/18/2024,202404180LAK,Los Angeles Kings,LAK,1,CHI,5,8,13,35,13,7,4,4,8,13,21,13
2023-24,4/18/2024,202404180MIN,Seattle Kraken,SEA,0,MIN,4,7,11,27,10,15,3,4,7,24,9,16
2023-24,4/18/2024,202404180VEG,Vegas Golden Knights,VEG,1,ANA,1,2,3,33,23,15,4,7,11,23,17,20
2023-24,4/18/2024,202404180WPG,Winnipeg Jets,WPG,1,VAN,4,5,9,26,23,19,2,2,4,20,32,11
2023-24,4/17/2024,202404170ARI,Arizona Coyotes,ARI,1,EDM,5,8,13,24,19,16,2,3,5,30,18,8
2023-24,4/17/2024,202404170DAL,Dallas Stars,DAL,1,STL,1,2,3,37,11,10,1,2,3,26,27,15
2023-24,4/17/2024,202404170NYI,New York Islanders,NYI,1,PIT,5,8,13,32,8,26,4,6,10,44,12,12
2023-24,4/17/2024,202404170TBL,Tampa Bay Lightning,TBL,1,TOR,6,11,17,32,38,17,4,7,11,38,32,16
2023-24,4/17/2024,202404170ARI,Edmonton Oilers,EDM,0,ARI,2,3,5,30,18,8,5,8,13,24,19,16
2023-24,4/17/2024,202404170DAL,St. Louis Blues,STL,0,DAL,1,2,3,26,27,15,1,2,3,37,11,10
2023-24,4/17/2024,202404170NYI,Pittsburgh Penguins,PIT,0,NYI,4,6,10,44,12,12,5,8,13,32,8,26
2023-24,4/17/2024,202404170TBL,Toronto Maple Leafs,TOR,0,TBL,4,7,11,38,32,16,6,11,17,32,38,17
2023-24,4/16/2024,202404160BOS,Boston Bruins,BOS,1,OTT,1,2,3,35,31,8,3,3,6,20,31,17
2023-24,4/16/2024,202404160CBJ,Carolina Hurricanes,CAR,0,CBJ,3,6,9,41,9,10,6,12,18,25,10,15
2023-24,4/16/2024,202404160FLA,Florida Panthers,FLA,1,TOR,5,8,13,42,45,13,2,2,4,26,38,17
2023-24,4/16/2024,202404160MTL,Detroit Red Wings,DET,0,MTL,4,5,9,40,19,11,4,8,12,33,13,15
2023-24,4/16/2024,202404160PHI,Philadelphia Flyers,PHI,1,WSH,1,2,3,28,38,26,2,3,5,18,28,32
2023-24,4/16/2024,202404160VAN,Calgary Flames,CGY,0,VAN,1,2,3,40,17,10,4,7,11,31,26,16
2023-24,4/16/2024,202404160VEG,Chicago Blackhawks,CHI,0,VEG,1,2,3,23,23,18,3,4,7,37,20,12
2023-24,4/16/2024,202404160WPG,Seattle Kraken,SEA,0,WPG,3,4,7,23,34,7,4,8,12,24,22,13
2023-24,4/16/2024,202404160BOS,Ottawa Senators,OTT,0,BOS,3,3,6,20,31,17,1,2,3,35,31,8
2023-24,4/16/2024,202404160CBJ,Columbus Blue Jackets,CBJ,1,CAR,6,12,18,25,10,15,3,6,9,41,9,10
2023-24,4/16/2024,202404160FLA,Toronto Maple Leafs,TOR,0,FLA,2,2,4,26,38,17,5,8,13,42,45,13
2023-24,4/16/2024,202404160MTL,Montreal Canadiens,MTL,1,DET,4,8,12,33,13,15,4,5,9,40,19,11
2023-24,4/16/2024,202404160PHI,Washington Capitals,WSH,0,PHI,2,3,5,18,28,32,1,2,3,28,38,26
2023-24,4/16/2024,202404160VAN,Vancouver Canucks,VAN,1,CGY,4,7,11,31,26,16,1,2,3,40,17,10
2023-24,4/16/2024,202404160VEG,Vegas Golden Knights,VEG,1,CHI,3,4,7,37,20,12,1,2,3,23,23,18
2023-24,4/16/2024,202404160WPG,Winnipeg Jets,WPG,1,SEA,4,8,12,24,22,13,3,4,7,23,34,7
2023-24,4/15/2024,202404150DET,Detroit Red Wings,DET,1,MTL,5,10,15,35,28,11,4,7,11,21,32,33
2023-24,4/15/2024,202404150EDM,Edmonton Oilers,EDM,1,SJS,9,15,24,38,20,8,2,3,5,21,40,18
2023-24,4/15/2024,202404150LAK,Los Angeles Kings,LAK,1,MIN,1,1,2,24,18,14,3,6,9,28,11,16
2023-24,4/15/2024,202404150NJD,New Jersey Devils,NJD,1,NYI,1,2,3,24,11,10,4,8,12,19,21,21
2023-24,4/15/2024,202404150NYR,New York Rangers,NYR,1,OTT,4,7,11,34,15,18,0,0,0,25,21,15
2023-24,4/15/2024,202404150PIT,Nashville Predators,NSH,0,PIT,2,3,5,30,26,20,4,8,12,38,11,18
2023-24,4/15/2024,202404150TBL,Buffalo Sabres,BUF,0,TBL,4,7,11,34,13,12,2,2,4,33,18,11
2023-24,4/15/2024,202404150WSH,Boston Bruins,BOS,0,WSH,0,0,0,16,50,11,2,2,4,25,41,14
2023-24,4/15/2024,202404150DET,Montreal Canadiens,MTL,0,DET,4,7,11,21,32,33,5,10,15,35,28,11
2023-24,4/15/2024,202404150EDM,San Jose Sharks,SJS,0,EDM,2,3,5,21,40,18,9,15,24,38,20,8
2023-24,4/15/2024,202404150LAK,Minnesota Wild,MIN,0,LAK,3,6,9,28,11,16,1,1,2,24,18,14
2023-24,4/15/2024,202404150NJD,New York Islanders,NYI,0,NJD,4,8,12,19,21,21,1,2,3,24,11,10
2023-24,4/15/2024,202404150NYR,Ottawa Senators,OTT,0,NYR,0,0,0,25,21,15,4,7,11,34,15,18
2023-24,4/15/2024,202404150PIT,Pittsburgh Penguins,PIT,1,NSH,4,8,12,38,11,18,2,3,5,30,26,20
2023-24,4/15/2024,202404150TBL,Tampa Bay Lightning,TBL,1,BUF,2,2,4,33,18,11,4,7,11,34,13,12
2023-24,4/15/2024,202404150WSH,Washington Capitals,WSH,1,BOS,2,2,4,25,41,14,0,0,0,16,50,11
2023-24,4/14/2024,202404140CGY,Arizona Coyotes,ARI,0,CGY,5,8,13,35,12,11,6,9,15,31,27,17
2023-24,4/14/2024,202404140CHI,Carolina Hurricanes,CAR,0,CHI,4,5,9,35,9,7,2,3,5,16,17,19
2023-24,4/14/2024,202404140STL,Seattle Kraken,SEA,0,STL,1,0,1,20,11,16,4,5,9,28,20,18
2023-24,4/14/2024,202404140VEG,Colorado Avalanche,COL,0,VEG,3,6,9,24,23,17,4,8,12,30,29,10
2023-24,4/14/2024,202404140CGY,Calgary Flames,CGY,1,ARI,6,9,15,31,27,17,5,8,13,35,12,11
2023-24,4/14/2024,202404140CHI,Chicago Blackhawks,CHI,1,CAR,2,3,5,16,17,19,4,5,9,35,9,7
2023-24,4/14/2024,202404140STL,St. Louis Blues,STL,1,SEA,4,5,9,28,20,18,1,0,1,20,11,16
2023-24,4/14/2024,202404140VEG,Vegas Golden Knights,VEG,1,COL,4,8,12,30,29,10,3,6,9,24,23,17
2023-24,4/13/2024,202404130COL,Colorado Avalanche,COL,1,WPG,0,0,0,30,28,14,7,11,18,26,15,17
2023-24,4/13/2024,202404130DAL,Dallas Stars,DAL,1,SEA,3,6,9,30,16,14,1,1,2,27,25,14
2023-24,4/13/2024,202404130EDM,Edmonton Oilers,EDM,1,VAN,1,2,3,33,36,8,3,5,8,27,47,21
2023-24,4/13/2024,202404130FLA,Buffalo Sabres,BUF,0,FLA,2,4,6,29,17,25,3,3,6,42,26,6
2023-24,4/13/2024,202404130LAK,Anaheim Ducks,ANA,0,LAK,1,2,3,29,20,12,3,6,9,28,18,2
2023-24,4/13/2024,202404130NSH,Columbus Blue Jackets,CBJ,0,NSH,4,6,10,37,23,4,6,12,18,37,16,19
2023-24,4/13/2024,202404130NYR,New York Islanders,NYI,0,NYR,2,4,6,36,25,25,2,3,5,43,24,14
2023-24,4/13/2024,202404130OTT,Montreal Canadiens,MTL,0,OTT,4,6,10,25,25,16,4,8,12,44,35,19
2023-24,4/13/2024,202404130PHI,New Jersey Devils,NJD,0,PHI,0,0,0,20,23,9,1,2,3,21,30,22
2023-24,4/13/2024,202404130PIT,Boston Bruins,BOS,0,PIT,6,10,16,31,29,21,4,7,11,32,17,15
2023-24,4/13/2024,202404130SJS,Minnesota Wild,MIN,0,SJS,6,12,18,38,5,19,2,4,6,29,19,10
2023-24,4/13/2024,202404130TOR,Detroit Red Wings,DET,0,TOR,5,10,15,32,41,20,4,5,9,36,35,11
2023-24,4/13/2024,202404130WSH,Tampa Bay Lightning,TBL,0,WSH,2,4,6,34,25,15,4,6,10,34,57,14
2023-24,4/13/2024,202404130COL,Winnipeg Jets,WPG,0,COL,7,11,18,26,15,17,0,0,0,30,28,14
2023-24,4/13/2024,202404130DAL,Seattle Kraken,SEA,0,DAL,1,1,2,27,25,14,3,6,9,30,16,14
2023-24,4/13/2024,202404130EDM,Vancouver Canucks,VAN,0,EDM,3,5,8,27,47,21,1,2,3,33,36,8
2023-24,4/13/2024,202404130FLA,Florida Panthers,FLA,1,BUF,3,3,6,42,26,6,2,4,6,29,17,25
2023-24,4/13/2024,202404130LAK,Los Angeles Kings,LAK,1,ANA,3,6,9,28,18,2,1,2,3,29,20,12
2023-24,4/13/2024,202404130NSH,Nashville Predators,NSH,1,CBJ,6,12,18,37,16,19,4,6,10,37,23,4
2023-24,4/13/2024,202404130NYR,New York Rangers,NYR,1,NYI,2,3,5,43,24,14,2,4,6,36,25,25
2023-24,4/13/2024,202404130OTT,Ottawa Senators,OTT,1,MTL,4,8,12,44,35,19,4,6,10,25,25,16
2023-24,4/13/2024,202404130PHI,Philadelphia Flyers,PHI,1,NJD,1,2,3,21,30,22,0,0,0,20,23,9
2023-24,4/13/2024,202404130PIT,Pittsburgh Penguins,PIT,1,BOS,4,7,11,32,17,15,6,10,16,31,29,21
2023-24,4/13/2024,202404130SJS,San Jose Sharks,SJS,1,MIN,2,4,6,29,19,10,6,12,18,38,5,19
2023-24,4/13/2024,202404130TOR,Toronto Maple Leafs,TOR,1,DET,4,5,9,36,35,11,5,10,15,32,41,20
2023-24,4/13/2024,202404130WSH,Washington Capitals,WSH,1,TBL,4,6,10,34,57,14,2,4,6,34,25,15
2023-24,4/12/2024,202404120ANA,Anaheim Ducks,ANA,1,CGY,3,6,9,22,21,24,6,12,18,27,23,13
2023-24,4/12/2024,202404120CHI,Chicago Blackhawks,CHI,1,NSH,1,2,3,26,22,12,5,7,12,40,12,12
2023-24,4/12/2024,202404120EDM,Arizona Coyotes,ARI,0,EDM,3,6,9,28,19,18,2,4,6,41,37,12
2023-24,4/12/2024,202404120STL,Carolina Hurricanes,CAR,0,STL,5,6,11,42,9,14,2,4,6,31,19,18
2023-24,4/12/2024,202404120VEG,Minnesota Wild,MIN,0,VEG,2,4,6,27,21,14,7,13,20,30,14,18
2023-24,4/12/2024,202404120ANA,Calgary Flames,CGY,0,ANA,6,12,18,27,23,13,3,6,9,22,21,24
2023-24,4/12/2024,202404120CHI,Nashville Predators,NSH,0,CHI,5,7,12,40,12,12,1,2,3,26,22,12
2023-24,4/12/2024,202404120EDM,Edmonton Oilers,EDM,1,ARI,2,4,6,41,37,12,3,6,9,28,19,18
2023-24,4/12/2024,202404120STL,St. Louis Blues,STL,1,CAR,2,4,6,31,19,18,5,6,11,42,9,14
2023-24,4/12/2024,202404120VEG,Vegas Golden Knights,VEG,1,MIN,7,13,20,30,14,18,2,4,6,27,21,14
2023-24,4/11/2024,202404110BUF,Buffalo Sabres,BUF,1,WSH,4,8,12,17,25,13,2,4,6,24,37,16
2023-24,4/11/2024,202404110DAL,Dallas Stars,DAL,1,WPG,0,0,0,24,31,6,3,4,7,24,32,18
2023-24,4/11/2024,202404110FLA,Columbus Blue Jackets,CBJ,0,FLA,0,0,0,25,39,18,4,7,11,46,16,8
2023-24,4/11/2024,202404110LAK,Calgary Flames,CGY,0,LAK,1,2,3,23,15,14,4,7,11,30,12,15
2023-24,4/11/2024,202404110NYI,Montreal Canadiens,MTL,0,NYI,2,4,6,14,23,21,3,5,8,31,25,10
2023-24,4/11/2024,202404110NYR,New York Rangers,NYR,1,PHI,1,2,3,25,17,8,4,5,9,26,18,19
2023-24,4/11/2024,202404110PIT,Detroit Red Wings,DET,0,PIT,5,9,14,30,22,19,6,9,15,27,16,13
2023-24,4/11/2024,202404110SEA,Seattle Kraken,SEA,1,SJS,1,1,2,50,20,6,3,6,9,23,37,28
2023-24,4/11/2024,202404110TBL,Ottawa Senators,OTT,0,TBL,2,3,5,27,40,13,2,4,6,26,27,20
2023-24,4/11/2024,202404110TOR,New Jersey Devils,NJD,0,TOR,6,5,11,20,36,18,5,8,13,32,34,17
2023-24,4/11/2024,202404110BUF,Washington Capitals,WSH,0,BUF,2,4,6,24,37,16,4,8,12,17,25,13
2023-24,4/11/2024,202404110DAL,Winnipeg Jets,WPG,0,DAL,3,4,7,24,32,18,0,0,0,24,31,6
2023-24,4/11/2024,202404110FLA,Florida Panthers,FLA,1,CBJ,4,7,11,46,16,8,0,0,0,25,39,18
2023-24,4/11/2024,202404110LAK,Los Angeles Kings,LAK,1,CGY,4,7,11,30,12,15,1,2,3,23,15,14
2023-24,4/11/2024,202404110NYI,New York Islanders,NYI,1,MTL,3,5,8,31,25,10,2,4,6,14,23,21
2023-24,4/11/2024,202404110NYR,Philadelphia Flyers,PHI,0,NYR,4,5,9,26,18,19,1,2,3,25,17,8
2023-24,4/11/2024,202404110PIT,Pittsburgh Penguins,PIT,1,DET,6,9,15,27,16,13,5,9,14,30,22,19
2023-24,4/11/2024,202404110SEA,San Jose Sharks,SJS,0,SEA,3,6,9,23,37,28,1,1,2,50,20,6
2023-24,4/11/2024,202404110TBL,Tampa Bay Lightning,TBL,1,OTT,2,4,6,26,27,20,2,3,5,27,40,13
2023-24,4/11/2024,202404110TOR,Toronto Maple Leafs,TOR,1,NJD,5,8,13,32,34,17,6,5,11,20,36,18
2023-24,4/10/2024,202404100EDM,Edmonton Oilers,EDM,1,VEG,5,8,13,25,24,18,1,2,3,18,35,13
2023-24,4/10/2024,202404100STL,Chicago Blackhawks,CHI,0,STL,2,3,5,20,28,16,5,9,14,26,18,10
2023-24,4/10/2024,202404100VAN,Arizona Coyotes,ARI,0,VAN,4,7,11,18,19,20,3,5,8,26,31,7
2023-24,4/10/2024,202404100EDM,Vegas Golden Knights,VEG,0,EDM,1,2,3,18,35,13,5,8,13,25,24,18
2023-24,4/10/2024,202404100STL,St. Louis Blues,STL,1,CHI,5,9,14,26,18,10,2,3,5,20,28,16
2023-24,4/10/2024,202404100VAN,Vancouver Canucks,VAN,1,ARI,3,5,8,26,31,7,4,7,11,18,19,20
2023-24,4/9/2024,202404090ANA,Anaheim Ducks,ANA,1,LAK,3,4,7,27,30,14,1,2,3,37,21,12
2023-24,4/9/2024,202404090BOS,Boston Bruins,BOS,1,CAR,1,1,2,23,40,10,4,6,10,26,33,10
2023-24,4/9/2024,202404090COL,Colorado Avalanche,COL,1,MIN,5,9,14,32,14,15,2,4,6,22,8,11
2023-24,4/9/2024,202404090DAL,Buffalo Sabres,BUF,0,DAL,2,4,6,21,24,8,3,4,7,24,23,20
2023-24,4/9/2024,202404090DET,Detroit Red Wings,DET,1,WSH,1,2,3,43,22,18,2,2,4,23,23,26
2023-24,4/9/2024,202404090FLA,Florida Panthers,FLA,1,OTT,2,2,4,30,31,12,0,0,0,26,44,23
2023-24,4/9/2024,202404090MTL,Montreal Canadiens,MTL,1,PHI,9,15,24,30,16,17,3,6,9,36,24,25
2023-24,4/9/2024,202404090NJD,New Jersey Devils,NJD,1,TOR,2,3,5,20,6,19,5,7,12,39,12,11
2023-24,4/9/2024,202404090NSH,Nashville Predators,NSH,1,WPG,3,5,8,48,28,13,4,6,10,22,17,17
2023-24,4/9/2024,202404090NYI,New York Islanders,NYI,1,NYR,4,7,11,28,18,34,2,4,6,33,22,7
2023-24,4/9/2024,202404090SEA,Arizona Coyotes,ARI,0,SEA,0,0,0,39,30,17,5,10,15,25,26,18
2023-24,4/9/2024,202404090SJS,Calgary Flames,CGY,0,SJS,3,6,9,41,20,9,2,3,5,22,21,26
2023-24,4/9/2024,202404090TBL,Columbus Blue Jackets,CBJ,0,TBL,2,4,6,32,29,14,5,9,14,33,39,15
2023-24,4/9/2024,202404090ANA,Los Angeles Kings,LAK,0,ANA,1,2,3,37,21,12,3,4,7,27,30,14
2023-24,4/9/2024,202404090BOS,Carolina Hurricanes,CAR,0,BOS,4,6,10,26,33,10,1,1,2,23,40,10
2023-24,4/9/2024,202404090COL,Minnesota Wild,MIN,0,COL,2,4,6,22,8,11,5,9,14,32,14,15
2023-24,4/9/2024,202404090DAL,Dallas Stars,DAL,1,BUF,3,4,7,24,23,20,2,4,6,21,24,8
2023-24,4/9/2024,202404090DET,Washington Capitals,WSH,0,DET,2,2,4,23,23,26,1,2,3,43,22,18
2023-24,4/9/2024,202404090FLA,Ottawa Senators,OTT,0,FLA,0,0,0,26,44,23,2,2,4,30,31,12
2023-24,4/9/2024,202404090MTL,Philadelphia Flyers,PHI,0,MTL,3,6,9,36,24,25,9,15,24,30,16,17
2023-24,4/9/2024,202404090NJD,Toronto Maple Leafs,TOR,0,NJD,5,7,12,39,12,11,2,3,5,20,6,19
2023-24,4/9/2024,202404090NSH,Winnipeg Jets,WPG,0,NSH,4,6,10,22,17,17,3,5,8,48,28,13
2023-24,4/9/2024,202404090NYI,New York Rangers,NYR,0,NYI,2,4,6,33,22,7,4,7,11,28,18,34
2023-24,4/9/2024,202404090SEA,Seattle Kraken,SEA,1,ARI,5,10,15,25,26,18,0,0,0,39,30,17
2023-24,4/9/2024,202404090SJS,San Jose Sharks,SJS,1,CGY,2,3,5,22,21,26,3,6,9,41,20,9
2023-24,4/9/2024,202404090TBL,Tampa Bay Lightning,TBL,1,CBJ,5,9,14,33,39,15,2,4,6,32,29,14
2023-24,4/8/2024,202404080TOR,Pittsburgh Penguins,PIT,0,TOR,2,3,5,33,31,20,3,5,8,23,30,13
2023-24,4/8/2024,202404080VAN,Vancouver Canucks,VAN,1,VEG,4,8,12,30,35,17,3,4,7,23,24,14
2023-24,4/8/2024,202404080TOR,Toronto Maple Leafs,TOR,1,PIT,3,5,8,23,30,13,2,3,5,33,31,20
2023-24,4/8/2024,202404080VAN,Vegas Golden Knights,VEG,0,VAN,3,4,7,23,24,14,4,8,12,30,35,17
2023-24,4/7/2024,202404070ANA,Anaheim Ducks,ANA,1,STL,5,10,15,38,21,12,5,10,15,31,16,13
2023-24,4/7/2024,202404070CAR,Carolina Hurricanes,CAR,1,CBJ,3,5,8,35,5,10,0,0,0,23,18,16
2023-24,4/7/2024,202404070CHI,Chicago Blackhawks,CHI,1,MIN,0,0,0,24,14,11,4,7,11,37,10,14
2023-24,4/7/2024,202404070COL,Colorado Avalanche,COL,1,DAL,4,7,11,38,37,17,7,12,19,37,14,27
2023-24,4/7/2024,202404070DET,Buffalo Sabres,BUF,0,DET,1,2,3,38,29,9,3,3,6,24,28,27
2023-24,4/7/2024,202404070NJD,New Jersey Devils,NJD,1,NSH,2,3,5,25,13,16,2,4,6,35,17,9
2023-24,4/7/2024,202404070NYR,Montreal Canadiens,MTL,0,NYR,2,3,5,28,23,16,5,9,14,46,23,8
2023-24,4/7/2024,202404070SJS,Arizona Coyotes,ARI,0,SJS,5,8,13,28,14,12,2,4,6,27,12,13
2023-24,4/7/2024,202404070WSH,Ottawa Senators,OTT,0,WSH,3,6,9,21,39,12,2,3,5,22,23,21
2023-24,4/7/2024,202404070ANA,St. Louis Blues,STL,0,ANA,5,10,15,31,16,13,5,10,15,38,21,12
2023-24,4/7/2024,202404070CAR,Columbus Blue Jackets,CBJ,0,CAR,0,0,0,23,18,16,3,5,8,35,5,10
2023-24,4/7/2024,202404070CHI,Minnesota Wild,MIN,0,CHI,4,7,11,37,10,14,0,0,0,24,14,11
2023-24,4/7/2024,202404070COL,Dallas Stars,DAL,0,COL,7,12,19,37,14,27,4,7,11,38,37,17
2023-24,4/7/2024,202404070DET,Detroit Red Wings,DET,1,BUF,3,3,6,24,28,27,1,2,3,38,29,9
2023-24,4/7/2024,202404070NJD,Nashville Predators,NSH,0,NJD,2,4,6,35,17,9,2,3,5,25,13,16
2023-24,4/7/2024,202404070NYR,New York Rangers,NYR,1,MTL,5,9,14,46,23,8,2,3,5,28,23,16
2023-24,4/7/2024,202404070SJS,San Jose Sharks,SJS,1,ARI,2,4,6,27,12,13,5,8,13,28,14,12
2023-24,4/7/2024,202404070WSH,Washington Capitals,WSH,1,OTT,2,3,5,22,23,21,3,6,9,21,39,12
2023-24,4/6/2024,202404060BOS,Boston Bruins,BOS,1,FLA,3,4,7,29,37,22,2,4,6,30,41,12
2023-24,4/6/2024,202404060CBJ,Columbus Blue Jackets,CBJ,1,PHI,6,11,17,33,10,15,2,3,5,39,13,19
2023-24,4/6/2024,202404060CGY,Calgary Flames,CGY,1,EDM,2,4,6,35,17,16,4,6,10,27,13,17
2023-24,4/6/2024,202404060CHI,Chicago Blackhawks,CHI,1,DAL,3,6,9,17,19,27,2,4,6,44,11,13
2023-24,4/6/2024,202404060LAK,Los Angeles Kings,LAK,1,VAN,6,9,15,29,17,22,3,5,8,42,33,5
2023-24,4/6/2024,202404060MIN,Minnesota Wild,MIN,1,WPG,2,3,5,27,14,13,4,7,11,25,12,15
2023-24,4/6/2024,202404060MTL,Montreal Canadiens,MTL,1,TOR,2,4,6,26,36,15,4,6,10,30,24,21
2023-24,4/6/2024,202404060NYI,Nashville Predators,NSH,0,NYI,0,0,0,42,17,8,2,3,5,30,33,33
2023-24,4/6/2024,202404060OTT,New Jersey Devils,NJD,0,OTT,4,7,11,27,19,21,3,4,7,28,42,22
2023-24,4/6/2024,202404060PIT,Pittsburgh Penguins,PIT,1,TBL,5,7,12,28,24,25,4,8,12,34,26,21
2023-24,4/6/2024,202404060SJS,San Jose Sharks,SJS,1,STL,3,5,8,25,10,8,2,4,6,35,15,7
2023-24,4/6/2024,202404060BOS,Florida Panthers,FLA,0,BOS,2,4,6,30,41,12,3,4,7,29,37,22
2023-24,4/6/2024,202404060CBJ,Philadelphia Flyers,PHI,0,CBJ,2,3,5,39,13,19,6,11,17,33,10,15
2023-24,4/6/2024,202404060CGY,Edmonton Oilers,EDM,0,CGY,4,6,10,27,13,17,2,4,6,35,17,16
2023-24,4/6/2024,202404060CHI,Dallas Stars,DAL,0,CHI,2,4,6,44,11,13,3,6,9,17,19,27
2023-24,4/6/2024,202404060LAK,Vancouver Canucks,VAN,0,LAK,3,5,8,42,33,5,6,9,15,29,17,22
2023-24,4/6/2024,202404060MIN,Winnipeg Jets,WPG,0,MIN,4,7,11,25,12,15,2,3,5,27,14,13
2023-24,4/6/2024,202404060MTL,Toronto Maple Leafs,TOR,0,MTL,4,6,10,30,24,21,2,4,6,26,36,15
2023-24,4/6/2024,202404060NYI,New York Islanders,NYI,1,NSH,2,3,5,30,33,33,0,0,0,42,17,8
2023-24,4/6/2024,202404060OTT,Ottawa Senators,OTT,1,NJD,3,4,7,28,42,22,4,7,11,27,19,21
2023-24,4/6/2024,202404060PIT,Tampa Bay Lightning,TBL,0,PIT,4,8,12,34,26,21,5,7,12,28,24,25
2023-24,4/6/2024,202404060SJS,St. Louis Blues,STL,0,SJS,2,4,6,35,15,7,3,5,8,25,10,8
2023-24,4/5/2024,202404050ANA,Anaheim Ducks,ANA,1,SEA,1,0,1,17,43,14,3,6,9,27,32,14
2023-24,4/5/2024,202404050ARI,Arizona Coyotes,ARI,1,VEG,7,12,19,32,42,16,4,8,12,24,36,20
2023-24,4/5/2024,202404050BUF,Buffalo Sabres,BUF,1,PHI,4,8,12,19,36,16,2,4,6,34,45,16
2023-24,4/5/2024,202404050CAR,Carolina Hurricanes,CAR,1,WSH,4,7,11,45,16,7,2,4,6,16,21,19
2023-24,4/5/2024,202404050DET,Detroit Red Wings,DET,1,NYR,3,6,9,34,23,15,4,6,10,38,18,13
2023-24,4/5/2024,202404050EDM,Colorado Avalanche,COL,0,EDM,2,4,6,24,34,8,6,12,18,47,18,11
2023-24,4/5/2024,202404050ANA,Seattle Kraken,SEA,0,ANA,3,6,9,27,32,14,1,0,1,17,43,14
2023-24,4/5/2024,202404050ARI,Vegas Golden Knights,VEG,0,ARI,4,8,12,24,36,20,7,12,19,32,42,16
2023-24,4/5/2024,202404050BUF,Philadelphia Flyers,PHI,0,BUF,2,4,6,34,45,16,4,8,12,19,36,16
2023-24,4/5/2024,202404050CAR,Washington Capitals,WSH,0,CAR,2,4,6,16,21,19,4,7,11,45,16,7
2023-24,4/5/2024,202404050DET,New York Rangers,NYR,0,DET,4,6,10,38,18,13,3,6,9,34,23,15
2023-24,4/5/2024,202404050EDM,Edmonton Oilers,EDM,1,COL,6,12,18,47,18,11,2,4,6,24,34,8
2023-24,4/4/2024,202404040CAR,Boston Bruins,BOS,0,CAR,4,6,10,28,16,21,1,2,3,29,17,11
2023-24,4/4/2024,202404040CBJ,Columbus Blue Jackets,CBJ,1,NYI,2,4,6,27,22,22,4,6,10,41,12,16
2023-24,4/4/2024,202404040MIN,Colorado Avalanche,COL,0,MIN,5,7,12,36,18,15,2,4,6,46,11,16
2023-24,4/4/2024,202404040MTL,Montreal Canadiens,MTL,1,TBL,4,8,12,30,23,15,7,12,19,35,21,21
2023-24,4/4/2024,202404040NSH,Nashville Predators,NSH,1,STL,6,9,15,31,19,19,3,5,8,47,28,19
2023-24,4/4/2024,202404040OTT,Florida Panthers,FLA,0,OTT,6,12,18,31,34,14,0,0,0,30,26,16
2023-24,4/4/2024,202404040SJS,Los Angeles Kings,LAK,0,SJS,2,2,4,27,10,9,1,2,3,16,22,13
2023-24,4/4/2024,202404040WPG,Calgary Flames,CGY,0,WPG,2,3,5,33,38,12,5,9,14,45,24,14
2023-24,4/4/2024,202404040WSH,Pittsburgh Penguins,PIT,0,WSH,4,8,12,24,38,18,1,2,3,31,53,8
2023-24,4/4/2024,202404040CAR,Carolina Hurricanes,CAR,1,BOS,1,2,3,29,17,11,4,6,10,28,16,21
2023-24,4/4/2024,202404040CBJ,New York Islanders,NYI,0,CBJ,4,6,10,41,12,16,2,4,6,27,22,22
2023-24,4/4/2024,202404040MIN,Minnesota Wild,MIN,1,COL,2,4,6,46,11,16,5,7,12,36,18,15
2023-24,4/4/2024,202404040MTL,Tampa Bay Lightning,TBL,0,MTL,7,12,19,35,21,21,4,8,12,30,23,15
2023-24,4/4/2024,202404040NSH,St. Louis Blues,STL,0,NSH,3,5,8,47,28,19,6,9,15,31,19,19
2023-24,4/4/2024,202404040OTT,Ottawa Senators,OTT,1,FLA,0,0,0,30,26,16,6,12,18,31,34,14
2023-24,4/4/2024,202404040SJS,San Jose Sharks,SJS,1,LAK,1,2,3,16,22,13,2,2,4,27,10,9
2023-24,4/4/2024,202404040WPG,Winnipeg Jets,WPG,1,CGY,5,9,14,45,24,14,2,3,5,33,38,12
2023-24,4/4/2024,202404040WSH,Washington Capitals,WSH,1,PIT,1,2,3,31,53,8,4,8,12,24,38,18
2023-24,4/3/2024,202404030ARI,Arizona Coyotes,ARI,1,VAN,1,2,3,21,33,9,2,4,6,33,44,17
2023-24,4/3/2024,202404030DAL,Dallas Stars,DAL,1,EDM,5,10,15,32,19,22,0,0,0,35,29,7
2023-24,4/3/2024,202404030LAK,Los Angeles Kings,LAK,1,SEA,5,8,13,27,16,17,2,4,6,23,27,14
2023-24,4/3/2024,202404030NYR,New Jersey Devils,NJD,0,NYR,3,5,8,20,15,12,4,6,10,41,16,13
2023-24,4/3/2024,202404030TOR,Tampa Bay Lightning,TBL,0,TOR,4,8,12,25,38,18,1,2,3,29,35,13
2023-24,4/3/2024,202404030ARI,Vancouver Canucks,VAN,0,ARI,2,4,6,33,44,17,1,2,3,21,33,9
2023-24,4/3/2024,202404030DAL,Edmonton Oilers,EDM,0,DAL,0,0,0,35,29,7,5,10,15,32,19,22
2023-24,4/3/2024,202404030LAK,Seattle Kraken,SEA,0,LAK,2,4,6,23,27,14,5,8,13,27,16,17
2023-24,4/3/2024,202404030NYR,New York Rangers,NYR,1,NJD,4,6,10,41,16,13,3,5,8,20,15,12
2023-24,4/3/2024,202404030TOR,Toronto Maple Leafs,TOR,1,TBL,1,2,3,29,35,13,4,8,12,25,38,18
2023-24,4/2/2024,202404020BUF,Buffalo Sabres,BUF,1,WSH,6,11,17,35,23,17,2,4,6,26,24,18
2023-24,4/2/2024,202404020CGY,Anaheim Ducks,ANA,0,CGY,5,9,14,29,17,13,3,6,9,24,28,16
2023-24,4/2/2024,202404020MIN,Minnesota Wild,MIN,1,OTT,3,4,7,19,10,19,2,4,6,32,11,7
2023-24,4/2/2024,202404020MTL,Florida Panthers,FLA,0,MTL,3,3,6,39,17,16,5,6,11,38,20,18
2023-24,4/2/2024,202404020NJD,New Jersey Devils,NJD,1,PIT,3,6,9,26,13,18,6,8,14,21,16,17
2023-24,4/2/2024,202404020NSH,Boston Bruins,BOS,0,NSH,3,5,8,32,10,20,0,0,0,31,23,9
2023-24,4/2/2024,202404020NYI,Chicago Blackhawks,CHI,0,NYI,1,2,3,19,12,14,2,4,6,29,11,12
2023-24,4/2/2024,202404020VEG,Vancouver Canucks,VAN,0,VEG,3,4,7,30,26,12,6,10,16,30,22,23
2023-24,4/2/2024,202404020BUF,Washington Capitals,WSH,0,BUF,2,4,6,26,24,18,6,11,17,35,23,17
2023-24,4/2/2024,202404020CGY,Calgary Flames,CGY,1,ANA,3,6,9,24,28,16,5,9,14,29,17,13
2023-24,4/2/2024,202404020MIN,Ottawa Senators,OTT,0,MIN,2,4,6,32,11,7,3,4,7,19,10,19
2023-24,4/2/2024,202404020MTL,Montreal Canadiens,MTL,1,FLA,5,6,11,38,20,18,3,3,6,39,17,16
2023-24,4/2/2024,202404020NJD,Pittsburgh Penguins,PIT,0,NJD,6,8,14,21,16,17,3,6,9,26,13,18
2023-24,4/2/2024,202404020NSH,Nashville Predators,NSH,1,BOS,0,0,0,31,23,9,3,5,8,32,10,20
2023-24,4/2/2024,202404020NYI,New York Islanders,NYI,1,CHI,2,4,6,29,11,12,1,2,3,19,12,14
2023-24,4/2/2024,202404020VEG,Vegas Golden Knights,VEG,1,VAN,6,10,16,30,22,23,3,4,7,30,26,12
2023-24,4/1/2024,202404010CBJ,Columbus Blue Jackets,CBJ,1,COL,4,8,12,25,24,13,1,2,3,46,7,19
2023-24,4/1/2024,202404010NYR,New York Rangers,NYR,1,PIT,2,3,5,30,20,12,5,7,12,20,15,17
2023-24,4/1/2024,202404010PHI,New York Islanders,NYI,0,PHI,4,5,9,27,36,26,3,2,5,34,27,21
2023-24,4/1/2024,202404010SJS,Seattle Kraken,SEA,0,SJS,4,7,11,32,10,18,2,4,6,26,26,13
2023-24,4/1/2024,202404010STL,Edmonton Oilers,EDM,0,STL,2,4,6,38,15,9,3,4,7,29,29,15
2023-24,4/1/2024,202404010TBL,Detroit Red Wings,DET,0,TBL,4,6,10,32,29,19,2,3,5,36,36,14
2023-24,4/1/2024,202404010TOR,Florida Panthers,FLA,0,TOR,4,7,11,30,49,6,6,6,12,23,43,14
2023-24,4/1/2024,202404010WPG,Los Angeles Kings,LAK,0,WPG,3,5,8,28,32,13,4,8,12,32,39,17
2023-24,4/1/2024,202404010CBJ,Colorado Avalanche,COL,0,CBJ,1,2,3,46,7,19,4,8,12,25,24,13
2023-24,4/1/2024,202404010NYR,Pittsburgh Penguins,PIT,0,NYR,5,7,12,20,15,17,2,3,5,30,20,12
2023-24,4/1/2024,202404010PHI,Philadelphia Flyers,PHI,1,NYI,3,2,5,34,27,21,4,5,9,27,36,26
2023-24,4/1/2024,202404010SJS,San Jose Sharks,SJS,1,SEA,2,4,6,26,26,13,4,7,11,32,10,18
2023-24,4/1/2024,202404010STL,St. Louis Blues,STL,1,EDM,3,4,7,29,29,15,2,4,6,38,15,9
2023-24,4/1/2024,202404010TBL,Tampa Bay Lightning,TBL,1,DET,2,3,5,36,36,14,4,6,10,32,29,19
2023-24,4/1/2024,202404010TOR,Toronto Maple Leafs,TOR,1,FLA,6,6,12,23,43,14,4,7,11,30,49,6
2023-24,4/1/2024,202404010WPG,Winnipeg Jets,WPG,1,LAK,4,8,12,32,39,17,3,5,8,28,32,13
2023-24,3/31/2024,202403310VAN,Anaheim Ducks,ANA,0,VAN,2,4,6,22,10,15,3,6,9,30,34,14
2023-24,3/31/2024,202403310VAN,Vancouver Canucks,VAN,1,ANA,3,6,9,30,34,14,2,4,6,22,10,15
2023-24,3/30/2024,202403300ARI,Arizona Coyotes,ARI,1,NYR,5,8,13,32,18,8,8,13,21,32,31,14
2023-24,3/30/2024,202403300BUF,Buffalo Sabres,BUF,1,TOR,0,0,0,34,24,9,3,4,7,22,41,20
2023-24,3/30/2024,202403300CBJ,Columbus Blue Jackets,CBJ,1,PIT,3,4,7,37,19,15,3,5,8,33,8,23
2023-24,3/30/2024,202403300CGY,Calgary Flames,CGY,1,LAK,4,8,12,35,22,18,2,4,6,18,28,27
2023-24,3/30/2024,202403300COL,Colorado Avalanche,COL,1,NSH,7,11,18,42,25,18,4,7,11,35,21,21
2023-24,3/30/2024,202403300EDM,Anaheim Ducks,ANA,0,EDM,1,2,3,22,33,14,6,11,17,37,19,13
2023-24,3/30/2024,202403300FLA,Detroit Red Wings,DET,0,FLA,2,4,6,22,33,25,2,4,6,38,41,7
2023-24,3/30/2024,202403300MIN,Minnesota Wild,MIN,1,VEG,1,2,3,33,13,21,2,3,5,31,20,16
2023-24,3/30/2024,202403300MTL,Carolina Hurricanes,CAR,0,MTL,3,5,8,30,5,11,0,0,0,26,21,21
2023-24,3/30/2024,202403300PHI,Chicago Blackhawks,CHI,0,PHI,5,9,14,24,33,13,1,1,2,31,27,11
2023-24,3/30/2024,202403300SEA,Dallas Stars,DAL,0,SEA,3,4,7,30,16,17,0,0,0,17,23,19
2023-24,3/30/2024,202403300STL,San Jose Sharks,SJS,0,STL,4,3,7,20,26,19,0,0,0,35,16,8
2023-24,3/30/2024,202403300TBL,New York Islanders,NYI,0,TBL,1,2,3,28,35,17,4,8,12,40,27,17
2023-24,3/30/2024,202403300WPG,Ottawa Senators,OTT,0,WPG,3,6,9,27,29,20,2,4,6,30,38,11
2023-24,3/30/2024,202403300WSH,Boston Bruins,BOS,0,WSH,2,2,4,29,38,29,2,4,6,20,41,19
2023-24,3/30/2024,202403300ARI,New York Rangers,NYR,0,ARI,8,13,21,32,31,14,5,8,13,32,18,8
2023-24,3/30/2024,202403300BUF,Toronto Maple Leafs,TOR,0,BUF,3,4,7,22,41,20,0,0,0,34,24,9
2023-24,3/30/2024,202403300CBJ,Pittsburgh Penguins,PIT,0,CBJ,3,5,8,33,8,23,3,4,7,37,19,15
2023-24,3/30/2024,202403300CGY,Los Angeles Kings,LAK,0,CGY,2,4,6,18,28,27,4,8,12,35,22,18
2023-24,3/30/2024,202403300COL,Nashville Predators,NSH,0,COL,4,7,11,35,21,21,7,11,18,42,25,18
2023-24,3/30/2024,202403300EDM,Edmonton Oilers,EDM,1,ANA,6,11,17,37,19,13,1,2,3,22,33,14
2023-24,3/30/2024,202403300FLA,Florida Panthers,FLA,1,DET,2,4,6,38,41,7,2,4,6,22,33,25
2023-24,3/30/2024,202403300MIN,Vegas Golden Knights,VEG,0,MIN,2,3,5,31,20,16,1,2,3,33,13,21
2023-24,3/30/2024,202403300MTL,Montreal Canadiens,MTL,1,CAR,0,0,0,26,21,21,3,5,8,30,5,11
2023-24,3/30/2024,202403300PHI,Philadelphia Flyers,PHI,1,CHI,1,1,2,31,27,11,5,9,14,24,33,13
2023-24,3/30/2024,202403300SEA,Seattle Kraken,SEA,1,DAL,0,0,0,17,23,19,3,4,7,30,16,17
2023-24,3/30/2024,202403300STL,St. Louis Blues,STL,1,SJS,0,0,0,35,16,8,4,3,7,20,26,19
2023-24,3/30/2024,202403300TBL,Tampa Bay Lightning,TBL,1,NYI,4,8,12,40,27,17,1,2,3,28,35,17
2023-24,3/30/2024,202403300WPG,Winnipeg Jets,WPG,1,OTT,2,4,6,30,38,11,3,6,9,27,29,20
2023-24,3/30/2024,202403300WSH,Washington Capitals,WSH,1,BOS,2,4,6,20,41,19,2,2,4,29,38,29
2023-24,3/29/2024,202403290BUF,Buffalo Sabres,BUF,1,NJD,5,6,11,36,37,17,2,4,6,30,18,12
2023-24,3/29/2024,202403290BUF,New Jersey Devils,NJD,0,BUF,2,4,6,30,18,12,5,6,11,36,37,17
2023-24,3/28/2024,202403280ARI,Arizona Coyotes,ARI,1,NSH,8,11,19,40,26,16,4,8,12,37,35,15
2023-24,3/28/2024,202403280CAR,Carolina Hurricanes,CAR,1,DET,4,8,12,33,13,13,0,0,0,24,18,11
2023-24,3/28/2024,202403280COL,Colorado Avalanche,COL,1,NYR,2,2,4,41,20,17,2,2,4,25,14,22
2023-24,3/28/2024,202403280EDM,Edmonton Oilers,EDM,1,LAK,4,7,11,20,47,16,1,1,2,32,32,18
2023-24,3/28/2024,202403280FLA,Florida Panthers,FLA,1,NYI,2,4,6,28,47,8,3,6,9,24,29,26
2023-24,3/28/2024,202403280MIN,Minnesota Wild,MIN,1,SJS,3,3,6,32,11,19,1,2,3,27,21,18
2023-24,3/28/2024,202403280MTL,Montreal Canadiens,MTL,1,PHI,4,8,12,17,27,22,1,2,3,30,21,13
2023-24,3/28/2024,202403280OTT,Chicago Blackhawks,CHI,0,OTT,0,0,0,19,29,14,2,1,3,34,35,13
2023-24,3/28/2024,202403280PIT,Columbus Blue Jackets,CBJ,0,PIT,2,4,6,19,26,12,3,6,9,36,12,17
2023-24,3/28/2024,202403280SEA,Anaheim Ducks,ANA,0,SEA,2,2,4,23,32,10,4,8,12,28,23,15
2023-24,3/28/2024,202403280STL,Calgary Flames,CGY,0,STL,3,4,7,28,21,11,5,8,13,19,17,16
2023-24,3/28/2024,202403280TOR,Toronto Maple Leafs,TOR,1,WSH,5,7,12,48,43,19,1,2,3,24,32,13
2023-24,3/28/2024,202403280VAN,Dallas Stars,DAL,0,VAN,3,6,9,34,22,18,1,2,3,28,40,17
2023-24,3/28/2024,202403280WPG,Vegas Golden Knights,VEG,0,WPG,4,4,8,27,46,20,1,2,3,40,41,7
2023-24,3/28/2024,202403280ARI,Nashville Predators,NSH,0,ARI,4,8,12,37,35,15,8,11,19,40,26,16
2023-24,3/28/2024,202403280CAR,Detroit Red Wings,DET,0,CAR,0,0,0,24,18,11,4,8,12,33,13,13
2023-24,3/28/2024,202403280COL,New York Rangers,NYR,0,COL,2,2,4,25,14,22,2,2,4,41,20,17
2023-24,3/28/2024,202403280EDM,Los Angeles Kings,LAK,0,EDM,1,1,2,32,32,18,4,7,11,20,47,16
2023-24,3/28/2024,202403280FLA,New York Islanders,NYI,0,FLA,3,6,9,24,29,26,2,4,6,28,47,8
2023-24,3/28/2024,202403280MIN,San Jose Sharks,SJS,0,MIN,1,2,3,27,21,18,3,3,6,32,11,19
2023-24,3/28/2024,202403280MTL,Philadelphia Flyers,PHI,0,MTL,1,2,3,30,21,13,4,8,12,17,27,22
2023-24,3/28/2024,202403280OTT,Ottawa Senators,OTT,1,CHI,2,1,3,34,35,13,0,0,0,19,29,14
2023-24,3/28/2024,202403280PIT,Pittsburgh Penguins,PIT,1,CBJ,3,6,9,36,12,17,2,4,6,19,26,12
2023-24,3/28/2024,202403280SEA,Seattle Kraken,SEA,1,ANA,4,8,12,28,23,15,2,2,4,23,32,10
2023-24,3/28/2024,202403280STL,St. Louis Blues,STL,1,CGY,5,8,13,19,17,16,3,4,7,28,21,11
2023-24,3/28/2024,202403280TOR,Washington Capitals,WSH,0,TOR,1,2,3,24,32,13,5,7,12,48,43,19
2023-24,3/28/2024,202403280VAN,Vancouver Canucks,VAN,1,DAL,1,2,3,28,40,17,3,6,9,34,22,18
2023-24,3/28/2024,202403280WPG,Winnipeg Jets,WPG,1,VEG,1,2,3,40,41,7,4,4,8,27,46,20
2023-24,3/27/2024,202403270BUF,Buffalo Sabres,BUF,1,OTT,2,3,5,36,32,10,6,11,17,42,26,18
2023-24,3/27/2024,202403270TBL,Boston Bruins,BOS,0,TBL,1,1,2,24,29,15,3,5,8,31,38,13
2023-24,3/27/2024,202403270BUF,Ottawa Senators,OTT,0,BUF,6,11,17,42,26,18,2,3,5,36,32,10
2023-24,3/27/2024,202403270TBL,Tampa Bay Lightning,TBL,1,BOS,3,5,8,31,38,13,1,1,2,24,29,15
2023-24,3/26/2024,202403260ARI,Arizona Coyotes,ARI,1,CBJ,6,6,12,35,22,12,2,4,6,27,27,15
2023-24,3/26/2024,202403260CHI,Calgary Flames,CGY,0,CHI,1,2,3,39,19,9,3,6,9,27,19,19
2023-24,3/26/2024,202403260COL,Colorado Avalanche,COL,1,MTL,1,2,3,28,13,12,2,4,6,27,18,20
2023-24,3/26/2024,202403260FLA,Boston Bruins,BOS,0,FLA,4,6,10,21,51,19,3,6,9,21,40,9
2023-24,3/26/2024,202403260NSH,Nashville Predators,NSH,1,VEG,5,9,14,35,49,20,4,8,12,35,21,17
2023-24,3/26/2024,202403260NYR,New York Rangers,NYR,1,PHI,6,8,14,27,23,17,5,5,10,42,16,13
2023-24,3/26/2024,202403260PIT,Carolina Hurricanes,CAR,0,PIT,1,0,1,39,15,10,4,4,8,22,18,19
2023-24,3/26/2024,202403260SEA,Anaheim Ducks,ANA,0,SEA,0,0,0,12,21,25,4,7,11,36,22,11
2023-24,3/26/2024,202403260SJS,Dallas Stars,DAL,0,SJS,6,8,14,41,7,15,3,5,8,20,18,17
2023-24,3/26/2024,202403260TOR,New Jersey Devils,NJD,0,TOR,6,11,17,25,28,15,3,6,9,45,47,7
2023-24,3/26/2024,202403260WPG,Edmonton Oilers,EDM,0,WPG,4,6,10,42,38,10,3,6,9,25,28,12
2023-24,3/26/2024,202403260WSH,Detroit Red Wings,DET,0,WSH,3,5,8,33,26,15,4,8,12,30,23,19
2023-24,3/26/2024,202403260ARI,Columbus Blue Jackets,CBJ,0,ARI,2,4,6,27,27,15,6,6,12,35,22,12
2023-24,3/26/2024,202403260CHI,Chicago Blackhawks,CHI,1,CGY,3,6,9,27,19,19,1,2,3,39,19,9
2023-24,3/26/2024,202403260COL,Montreal Canadiens,MTL,0,COL,2,4,6,27,18,20,1,2,3,28,13,12
2023-24,3/26/2024,202403260FLA,Florida Panthers,FLA,1,BOS,3,6,9,21,40,9,4,6,10,21,51,19
2023-24,3/26/2024,202403260NSH,Vegas Golden Knights,VEG,0,NSH,4,8,12,35,21,17,5,9,14,35,49,20
2023-24,3/26/2024,202403260NYR,Philadelphia Flyers,PHI,0,NYR,5,5,10,42,16,13,6,8,14,27,23,17
2023-24,3/26/2024,202403260PIT,Pittsburgh Penguins,PIT,1,CAR,4,4,8,22,18,19,1,0,1,39,15,10
2023-24,3/26/2024,202403260SEA,Seattle Kraken,SEA,1,ANA,4,7,11,36,22,11,0,0,0,12,21,25
2023-24,3/26/2024,202403260SJS,San Jose Sharks,SJS,1,DAL,3,5,8,20,18,17,6,8,14,41,7,15
2023-24,3/26/2024,202403260TOR,Toronto Maple Leafs,TOR,1,NJD,3,6,9,45,47,7,6,11,17,25,28,15
2023-24,3/26/2024,202403260WPG,Winnipeg Jets,WPG,1,EDM,3,6,9,25,28,12,4,6,10,42,38,10
2023-24,3/26/2024,202403260WSH,Washington Capitals,WSH,1,DET,4,8,12,30,23,19,3,5,8,33,26,15
2023-24,3/25/2024,202403250STL,St. Louis Blues,STL,1,VEG,1,2,3,32,27,18,2,4,6,34,22,14
2023-24,3/25/2024,202403250VAN,Los Angeles Kings,LAK,0,VAN,3,6,9,19,25,13,2,3,5,23,47,6
2023-24,3/25/2024,202403250STL,Vegas Golden Knights,VEG,0,STL,2,4,6,34,22,14,1,2,3,32,27,18
2023-24,3/25/2024,202403250VAN,Vancouver Canucks,VAN,1,LAK,2,3,5,23,47,6,3,6,9,19,25,13
2023-24,3/24/2024,202403240ANA,Anaheim Ducks,ANA,1,TBL,2,4,6,32,21,17,3,4,7,27,34,14
2023-24,3/24/2024,202403240ARI,Arizona Coyotes,ARI,1,DAL,2,4,6,28,35,21,4,6,10,35,16,12
2023-24,3/24/2024,202403240CAR,Carolina Hurricanes,CAR,1,TOR,2,4,6,43,6,13,1,1,2,33,14,16
2023-24,3/24/2024,202403240CGY,Buffalo Sabres,BUF,0,CGY,4,3,7,29,15,22,1,2,3,33,15,16
2023-24,3/24/2024,202403240COL,Colorado Avalanche,COL,1,PIT,5,9,14,30,15,16,4,6,10,34,21,16
2023-24,3/24/2024,202403240NYI,New Jersey Devils,NJD,0,NYI,4,7,11,30,14,15,0,0,0,36,22,24
2023-24,3/24/2024,202403240OTT,Edmonton Oilers,EDM,0,OTT,3,6,9,36,18,9,5,9,14,16,26,12
2023-24,3/24/2024,202403240PHI,Florida Panthers,FLA,0,PHI,4,7,11,15,39,26,1,2,3,33,32,8
2023-24,3/24/2024,202403240SEA,Montreal Canadiens,MTL,0,SEA,5,8,13,17,17,19,1,2,3,37,25,13
2023-24,3/24/2024,202403240WSH,Winnipeg Jets,WPG,0,WSH,0,0,0,27,20,15,3,5,8,19,29,15
2023-24,3/24/2024,202403240ANA,Tampa Bay Lightning,TBL,0,ANA,3,4,7,27,34,14,2,4,6,32,21,17
2023-24,3/24/2024,202403240ARI,Dallas Stars,DAL,0,ARI,4,6,10,35,16,12,2,4,6,28,35,21
2023-24,3/24/2024,202403240CAR,Toronto Maple Leafs,TOR,0,CAR,1,1,2,33,14,16,2,4,6,43,6,13
2023-24,3/24/2024,202403240CGY,Calgary Flames,CGY,1,BUF,1,2,3,33,15,16,4,3,7,29,15,22
2023-24,3/24/2024,202403240COL,Pittsburgh Penguins,PIT,0,COL,4,6,10,34,21,16,5,9,14,30,15,16
2023-24,3/24/2024,202403240NYI,New York Islanders,NYI,1,NJD,0,0,0,36,22,24,4,7,11,30,14,15
2023-24,3/24/2024,202403240OTT,Ottawa Senators,OTT,1,EDM,5,9,14,16,26,12,3,6,9,36,18,9
2023-24,3/24/2024,202403240PHI,Philadelphia Flyers,PHI,1,FLA,1,2,3,33,32,8,4,7,11,15,39,26
2023-24,3/24/2024,202403240SEA,Seattle Kraken,SEA,1,MTL,1,2,3,37,25,13,5,8,13,17,17,19
2023-24,3/24/2024,202403240WSH,Washington Capitals,WSH,1,WPG,3,5,8,19,29,15,0,0,0,27,20,15
2023-24,3/23/2024,202403230LAK,Los Angeles Kings,LAK,1,TBL,4,5,9,23,19,25,3,4,7,25,24,17
2023-24,3/23/2024,202403230MIN,Minnesota Wild,MIN,1,STL,4,7,11,34,15,10,5,8,13,27,17,12
2023-24,3/23/2024,202403230NJD,New Jersey Devils,NJD,1,OTT,2,2,4,20,10,10,5,6,11,25,8,11
2023-24,3/23/2024,202403230NSH,Detroit Red Wings,DET,0,NSH,0,0,0,22,5,14,1,2,3,32,25,13
2023-24,3/23/2024,202403230NYI,New York Islanders,NYI,1,WPG,6,10,16,39,25,17,3,4,7,35,27,15
2023-24,3/23/2024,202403230NYR,Florida Panthers,FLA,0,NYR,3,6,9,30,24,19,3,6,9,37,28,11
2023-24,3/23/2024,202403230PHI,Boston Bruins,BOS,0,PHI,2,4,6,20,39,8,3,5,8,29,39,18
2023-24,3/23/2024,202403230SJS,Chicago Blackhawks,CHI,0,SJS,5,9,14,31,25,19,4,8,12,30,16,12
2023-24,3/23/2024,202403230TOR,Edmonton Oilers,EDM,0,TOR,3,6,9,39,31,11,6,9,15,29,33,28
2023-24,3/23/2024,202403230VAN,Calgary Flames,CGY,0,VAN,2,4,6,24,23,10,4,6,10,26,29,21
2023-24,3/23/2024,202403230VEG,Columbus Blue Jackets,CBJ,0,VEG,2,3,5,22,36,22,4,7,11,47,17,13
2023-24,3/23/2024,202403230LAK,Tampa Bay Lightning,TBL,0,LAK,3,4,7,25,24,17,4,5,9,23,19,25
2023-24,3/23/2024,202403230MIN,St. Louis Blues,STL,0,MIN,5,8,13,27,17,12,4,7,11,34,15,10
2023-24,3/23/2024,202403230NJD,Ottawa Senators,OTT,0,NJD,5,6,11,25,8,11,2,2,4,20,10,10
2023-24,3/23/2024,202403230NSH,Nashville Predators,NSH,1,DET,1,2,3,32,25,13,0,0,0,22,5,14
2023-24,3/23/2024,202403230NYI,Winnipeg Jets,WPG,0,NYI,3,4,7,35,27,15,6,10,16,39,25,17
2023-24,3/23/2024,202403230NYR,New York Rangers,NYR,1,FLA,3,6,9,37,28,11,3,6,9,30,24,19
2023-24,3/23/2024,202403230PHI,Philadelphia Flyers,PHI,1,BOS,3,5,8,29,39,18,2,4,6,20,39,8
2023-24,3/23/2024,202403230SJS,San Jose Sharks,SJS,1,CHI,4,8,12,30,16,12,5,9,14,31,25,19
2023-24,3/23/2024,202403230TOR,Toronto Maple Leafs,TOR,1,EDM,6,9,15,29,33,28,3,6,9,39,31,11
2023-24,3/23/2024,202403230VAN,Vancouver Canucks,VAN,1,CGY,4,6,10,26,29,21,2,4,6,24,23,10
2023-24,3/23/2024,202403230VEG,Vegas Golden Knights,VEG,1,CBJ,4,7,11,47,17,13,2,3,5,22,36,22
2023-24,3/22/2024,202403220ARI,Arizona Coyotes,ARI,1,SEA,2,3,5,26,30,20,1,2,3,28,20,8
2023-24,3/22/2024,202403220COL,Columbus Blue Jackets,CBJ,0,COL,1,2,3,24,20,24,6,11,17,50,26,11
2023-24,3/22/2024,202403220DAL,Dallas Stars,DAL,1,PIT,4,6,10,23,19,18,2,4,6,22,26,14
2023-24,3/22/2024,202403220WSH,Carolina Hurricanes,CAR,0,WSH,6,10,16,31,16,22,6,10,16,25,30,17
2023-24,3/22/2024,202403220ARI,Seattle Kraken,SEA,0,ARI,1,2,3,28,20,8,2,3,5,26,30,20
2023-24,3/22/2024,202403220COL,Colorado Avalanche,COL,1,CBJ,6,11,17,50,26,11,1,2,3,24,20,24
2023-24,3/22/2024,202403220DAL,Pittsburgh Penguins,PIT,0,DAL,2,4,6,22,26,14,4,6,10,23,19,18
2023-24,3/22/2024,202403220WSH,Washington Capitals,WSH,1,CAR,6,10,16,25,30,17,6,10,16,31,16,22
2023-24,3/21/2024,202403210ANA,Anaheim Ducks,ANA,1,CHI,4,8,12,25,20,11,0,0,0,29,29,14
2023-24,3/21/2024,202403210BOS,Boston Bruins,BOS,1,NYR,2,4,6,26,40,19,5,7,12,31,44,8
2023-24,3/21/2024,202403210CAR,Carolina Hurricanes,CAR,1,PHI,3,5,8,33,16,16,2,4,6,32,19,27
2023-24,3/21/2024,202403210DET,Detroit Red Wings,DET,1,NYI,6,10,16,24,27,22,3,6,9,36,17,11
2023-24,3/21/2024,202403210EDM,Buffalo Sabres,BUF,0,EDM,3,5,8,29,28,20,8,14,22,39,32,17
2023-24,3/21/2024,202403210FLA,Florida Panthers,FLA,1,NSH,0,0,0,33,34,16,3,6,9,37,30,16
2023-24,3/21/2024,202403210NJD,New Jersey Devils,NJD,1,WPG,4,8,12,41,11,19,1,2,3,19,10,11
2023-24,3/21/2024,202403210OTT,Ottawa Senators,OTT,1,STL,2,3,5,39,22,8,5,6,11,27,22,16
2023-24,3/21/2024,202403210SJS,San Jose Sharks,SJS,1,TBL,1,1,2,22,21,12,4,8,12,21,17,18
2023-24,3/21/2024,202403210VAN,Montreal Canadiens,MTL,0,VAN,1,1,2,17,25,18,4,7,11,25,42,12
2023-24,3/21/2024,202403210VEG,Seattle Kraken,SEA,0,VEG,1,2,3,22,31,16,3,5,8,37,36,23
2023-24,3/21/2024,202403210ANA,Chicago Blackhawks,CHI,0,ANA,0,0,0,29,29,14,4,8,12,25,20,11
2023-24,3/21/2024,202403210BOS,New York Rangers,NYR,0,BOS,5,7,12,31,44,8,2,4,6,26,40,19
2023-24,3/21/2024,202403210CAR,Philadelphia Flyers,PHI,0,CAR,2,4,6,32,19,27,3,5,8,33,16,16
2023-24,3/21/2024,202403210DET,New York Islanders,NYI,0,DET,3,6,9,36,17,11,6,10,16,24,27,22
2023-24,3/21/2024,202403210EDM,Edmonton Oilers,EDM,1,BUF,8,14,22,39,32,17,3,5,8,29,28,20
2023-24,3/21/2024,202403210FLA,Nashville Predators,NSH,0,FLA,3,6,9,37,30,16,0,0,0,33,34,16
2023-24,3/21/2024,202403210NJD,Winnipeg Jets,WPG,0,NJD,1,2,3,19,10,11,4,8,12,41,11,19
2023-24,3/21/2024,202403210OTT,St. Louis Blues,STL,0,OTT,5,6,11,27,22,16,2,3,5,39,22,8
2023-24,3/21/2024,202403210SJS,Tampa Bay Lightning,TBL,0,SJS,4,8,12,21,17,18,1,1,2,22,21,12
2023-24,3/21/2024,202403210VAN,Vancouver Canucks,VAN,1,MTL,4,7,11,25,42,12,1,1,2,17,25,18
2023-24,3/21/2024,202403210VEG,Vegas Golden Knights,VEG,1,SEA,3,5,8,37,36,23,1,2,3,22,31,16
2023-24,3/20/2024,202403200DAL,Arizona Coyotes,ARI,0,DAL,2,4,6,25,39,14,5,10,15,33,21,9
2023-24,3/20/2024,202403200LAK,Los Angeles Kings,LAK,1,MIN,6,12,18,27,17,14,0,0,0,31,19,13
2023-24,3/20/2024,202403200WSH,Toronto Maple Leafs,TOR,0,WSH,7,13,20,29,34,20,3,5,8,21,37,18
2023-24,3/20/2024,202403200DAL,Dallas Stars,DAL,1,ARI,5,10,15,33,21,9,2,4,6,25,39,14
2023-24,3/20/2024,202403200LAK,Minnesota Wild,MIN,0,LAK,0,0,0,31,19,13,6,12,18,27,17,14
2023-24,3/20/2024,202403200WSH,Washington Capitals,WSH,1,TOR,3,5,8,21,37,18,7,13,20,29,34,20
2023-24,3/19/2024,202403190ANA,Anaheim Ducks,ANA,1,MIN,0,0,0,27,17,16,4,7,11,32,16,10
2023-24,3/19/2024,202403190BOS,Boston Bruins,BOS,1,OTT,6,10,16,26,29,16,2,4,6,31,30,15
2023-24,3/19/2024,202403190DET,Columbus Blue Jackets,CBJ,0,DET,3,4,7,35,17,17,4,8,12,26,16,16
2023-24,3/19/2024,202403190EDM,Edmonton Oilers,EDM,1,MTL,3,5,8,32,28,20,2,4,6,25,26,21
2023-24,3/19/2024,202403190LAK,Chicago Blackhawks,CHI,0,LAK,2,4,6,24,22,9,6,11,17,24,16,21
2023-24,3/19/2024,202403190NJD,New Jersey Devils,NJD,1,PIT,5,10,15,38,11,18,2,3,5,38,13,17
2023-24,3/19/2024,202403190NSH,Nashville Predators,NSH,1,SJS,8,15,23,40,17,21,2,4,6,20,28,12
2023-24,3/19/2024,202403190NYI,Carolina Hurricanes,CAR,0,NYI,4,7,11,34,15,13,1,2,3,31,20,15
2023-24,3/19/2024,202403190NYR,New York Rangers,NYR,1,WPG,2,4,6,41,22,14,4,6,10,27,17,17
2023-24,3/19/2024,202403190PHI,Philadelphia Flyers,PHI,1,TOR,4,5,9,30,34,36,3,6,9,30,28,9
2023-24,3/19/2024,202403190STL,Colorado Avalanche,COL,0,STL,4,7,11,35,16,13,3,5,8,33,28,14
2023-24,3/19/2024,202403190VAN,Buffalo Sabres,BUF,0,VAN,2,4,6,17,18,14,3,5,8,34,34,23
2023-24,3/19/2024,202403190VEG,Tampa Bay Lightning,TBL,0,VEG,5,8,13,21,27,16,3,4,7,27,36,10
2023-24,3/19/2024,202403190ANA,Minnesota Wild,MIN,0,ANA,4,7,11,32,16,10,0,0,0,27,17,16
2023-24,3/19/2024,202403190BOS,Ottawa Senators,OTT,0,BOS,2,4,6,31,30,15,6,10,16,26,29,16
2023-24,3/19/2024,202403190DET,Detroit Red Wings,DET,1,CBJ,4,8,12,26,16,16,3,4,7,35,17,17
2023-24,3/19/2024,202403190EDM,Montreal Canadiens,MTL,0,EDM,2,4,6,25,26,21,3,5,8,32,28,20
2023-24,3/19/2024,202403190LAK,Los Angeles Kings,LAK,1,CHI,6,11,17,24,16,21,2,4,6,24,22,9
2023-24,3/19/2024,202403190NJD,Pittsburgh Penguins,PIT,0,NJD,2,3,5,38,13,17,5,10,15,38,11,18
2023-24,3/19/2024,202403190NSH,San Jose Sharks,SJS,0,NSH,2,4,6,20,28,12,8,15,23,40,17,21
2023-24,3/19/2024,202403190NYI,New York Islanders,NYI,1,CAR,1,2,3,31,20,15,4,7,11,34,15,13
2023-24,3/19/2024,202403190NYR,Winnipeg Jets,WPG,0,NYR,4,6,10,27,17,17,2,4,6,41,22,14
2023-24,3/19/2024,202403190PHI,Toronto Maple Leafs,TOR,0,PHI,3,6,9,30,28,9,4,5,9,30,34,36
2023-24,3/19/2024,202403190STL,St. Louis Blues,STL,1,COL,3,5,8,33,28,14,4,7,11,35,16,13
2023-24,3/19/2024,202403190VAN,Vancouver Canucks,VAN,1,BUF,3,5,8,34,34,23,2,4,6,17,18,14
2023-24,3/19/2024,202403190VEG,Vegas Golden Knights,VEG,1,TBL,3,4,7,27,36,10,5,8,13,21,27,16
2023-24,3/18/2024,202403180CGY,Calgary Flames,CGY,1,WSH,2,3,5,36,15,25,5,9,14,33,10,23
2023-24,3/18/2024,202403180SEA,Buffalo Sabres,BUF,0,SEA,6,9,15,30,28,22,2,4,6,34,38,10
2023-24,3/18/2024,202403180CGY,Washington Capitals,WSH,0,CGY,5,9,14,33,10,23,2,3,5,36,15,25
2023-24,3/18/2024,202403180SEA,Seattle Kraken,SEA,1,BUF,2,4,6,34,38,10,6,9,15,30,28,22
2023-24,3/17/2024,202403170CBJ,Columbus Blue Jackets,CBJ,1,WPG,1,2,3,31,14,11,6,8,14,27,8,22
2023-24,3/17/2024,202403170CHI,Chicago Blackhawks,CHI,1,SJS,5,9,14,31,29,18,2,4,6,27,15,12
2023-24,3/17/2024,202403170NYR,New York Islanders,NYI,0,NYR,2,3,5,27,26,21,5,9,14,31,21,12
2023-24,3/17/2024,202403170OTT,Carolina Hurricanes,CAR,0,OTT,7,14,21,38,18,10,2,4,6,32,23,15
2023-24,3/17/2024,202403170PIT,Detroit Red Wings,DET,0,PIT,3,6,9,28,20,16,6,10,16,38,18,18
2023-24,3/17/2024,202403170STL,Anaheim Ducks,ANA,0,STL,2,4,6,28,20,16,4,8,12,27,18,14
2023-24,3/17/2024,202403170VEG,New Jersey Devils,NJD,0,VEG,1,0,1,21,12,12,3,5,8,37,25,21
2023-24,3/17/2024,202403170CBJ,Winnipeg Jets,WPG,0,CBJ,6,8,14,27,8,22,1,2,3,31,14,11
2023-24,3/17/2024,202403170CHI,San Jose Sharks,SJS,0,CHI,2,4,6,27,15,12,5,9,14,31,29,18
2023-24,3/17/2024,202403170NYR,New York Rangers,NYR,1,NYI,5,9,14,31,21,12,2,3,5,27,26,21
2023-24,3/17/2024,202403170OTT,Ottawa Senators,OTT,1,CAR,2,4,6,32,23,15,7,14,21,38,18,10
2023-24,3/17/2024,202403170PIT,Pittsburgh Penguins,PIT,1,DET,6,10,16,38,18,18,3,6,9,28,20,16
2023-24,3/17/2024,202403170STL,St. Louis Blues,STL,1,ANA,4,8,12,27,18,14,2,4,6,28,20,16
2023-24,3/17/2024,202403170VEG,Vegas Golden Knights,VEG,1,NJD,3,5,8,37,25,21,1,0,1,21,12,12
2023-24,3/16/2024,202403160ARI,Arizona Coyotes,ARI,1,NJD,4,6,10,32,12,22,1,2,3,38,25,15
2023-24,3/16/2024,202403160BOS,Boston Bruins,BOS,1,PHI,6,11,17,30,29,22,5,8,13,29,35,16
2023-24,3/16/2024,202403160CBJ,Columbus Blue Jackets,CBJ,1,SJS,4,7,11,20,21,19,2,3,5,41,14,18
2023-24,3/16/2024,202403160CGY,Calgary Flames,CGY,1,MTL,5,10,15,28,20,20,2,4,6,38,18,17
2023-24,3/16/2024,202403160DAL,Dallas Stars,DAL,1,LAK,4,7,11,29,18,18,1,1,2,28,42,12
2023-24,3/16/2024,202403160DET,Buffalo Sabres,BUF,0,DET,1,2,3,26,31,13,4,7,11,26,30,13
2023-24,3/16/2024,202403160EDM,Colorado Avalanche,COL,0,EDM,3,6,9,43,30,18,2,3,5,34,39,26
2023-24,3/16/2024,202403160FLA,Florida Panthers,FLA,1,TBL,3,3,6,50,25,10,5,9,14,16,15,16
2023-24,3/16/2024,202403160NYI,New York Islanders,NYI,1,OTT,3,6,9,33,25,18,4,8,12,30,18,22
2023-24,3/16/2024,202403160PIT,New York Rangers,NYR,0,PIT,7,13,20,28,18,19,4,8,12,37,22,10
2023-24,3/16/2024,202403160SEA,Nashville Predators,NSH,0,SEA,4,6,10,30,26,17,1,2,3,24,33,13
2023-24,3/16/2024,202403160STL,Minnesota Wild,MIN,0,STL,2,3,5,24,14,17,2,4,6,37,22,31
2023-24,3/16/2024,202403160TOR,Carolina Hurricanes,CAR,0,TOR,4,8,12,40,25,15,4,5,9,40,37,16
2023-24,3/16/2024,202403160VAN,Vancouver Canucks,VAN,1,WSH,1,2,3,22,33,9,2,4,6,24,16,20
2023-24,3/16/2024,202403160ARI,New Jersey Devils,NJD,0,ARI,1,2,3,38,25,15,4,6,10,32,12,22
2023-24,3/16/2024,202403160BOS,Philadelphia Flyers,PHI,0,BOS,5,8,13,29,35,16,6,11,17,30,29,22
2023-24,3/16/2024,202403160CBJ,San Jose Sharks,SJS,0,CBJ,2,3,5,41,14,18,4,7,11,20,21,19
2023-24,3/16/2024,202403160CGY,Montreal Canadiens,MTL,0,CGY,2,4,6,38,18,17,5,10,15,28,20,20
2023-24,3/16/2024,202403160DAL,Los Angeles Kings,LAK,0,DAL,1,1,2,28,42,12,4,7,11,29,18,18
2023-24,3/16/2024,202403160DET,Detroit Red Wings,DET,1,BUF,4,7,11,26,30,13,1,2,3,26,31,13
2023-24,3/16/2024,202403160EDM,Edmonton Oilers,EDM,1,COL,2,3,5,34,39,26,3,6,9,43,30,18
2023-24,3/16/2024,202403160FLA,Tampa Bay Lightning,TBL,0,FLA,5,9,14,16,15,16,3,3,6,50,25,10
2023-24,3/16/2024,202403160NYI,Ottawa Senators,OTT,0,NYI,4,8,12,30,18,22,3,6,9,33,25,18
2023-24,3/16/2024,202403160PIT,Pittsburgh Penguins,PIT,1,NYR,4,8,12,37,22,10,7,13,20,28,18,19
2023-24,3/16/2024,202403160SEA,Seattle Kraken,SEA,1,NSH,1,2,3,24,33,13,4,6,10,30,26,17
2023-24,3/16/2024,202403160STL,St. Louis Blues,STL,1,MIN,2,4,6,37,22,31,2,3,5,24,14,17
2023-24,3/16/2024,202403160TOR,Toronto Maple Leafs,TOR,1,CAR,4,5,9,40,37,16,4,8,12,40,25,15
2023-24,3/16/2024,202403160VAN,Washington Capitals,WSH,0,VAN,2,4,6,24,16,20,1,2,3,22,33,9
2023-24,3/15/2024,202403150CHI,Chicago Blackhawks,CHI,1,LAK,0,0,0,28,26,15,5,10,15,37,9,19
2023-24,3/15/2024,202403150WPG,Anaheim Ducks,ANA,0,WPG,0,0,0,21,20,16,6,11,17,38,24,9
2023-24,3/15/2024,202403150CHI,Los Angeles Kings,LAK,0,CHI,5,10,15,37,9,19,0,0,0,28,26,15
2023-24,3/15/2024,202403150WPG,Winnipeg Jets,WPG,1,ANA,6,11,17,38,24,9,0,0,0,21,20,16
2023-24,3/14/2024,202403140BUF,Buffalo Sabres,BUF,1,NYI,4,8,12,37,23,9,0,0,0,21,51,9
2023-24,3/14/2024,202403140CAR,Carolina Hurricanes,CAR,1,FLA,4,6,10,35,26,10,0,0,0,21,41,10
2023-24,3/14/2024,202403140CBJ,Columbus Blue Jackets,CBJ,1,OTT,2,4,6,37,14,23,2,4,6,37,12,22
2023-24,3/14/2024,202403140CGY,Calgary Flames,CGY,1,VEG,4,7,11,37,19,30,1,1,2,29,20,19
2023-24,3/14/2024,202403140DAL,Dallas Stars,DAL,1,NJD,2,4,6,37,27,7,6,9,15,20,22,23
2023-24,3/14/2024,202403140DET,Arizona Coyotes,ARI,0,DET,4,7,11,27,16,18,1,2,3,29,20,18
2023-24,3/14/2024,202403140MIN,Anaheim Ducks,ANA,0,MIN,0,0,0,16,16,14,2,4,6,31,14,16
2023-24,3/14/2024,202403140MTL,Boston Bruins,BOS,0,MTL,2,4,6,24,20,18,1,1,2,19,17,19
2023-24,3/14/2024,202403140PHI,Philadelphia Flyers,PHI,1,TOR,2,4,6,28,37,18,6,11,17,27,28,12
2023-24,3/14/2024,202403140PIT,Pittsburgh Penguins,PIT,1,SJS,6,11,17,31,23,20,3,6,9,32,27,20
2023-24,3/14/2024,202403140SEA,Seattle Kraken,SEA,1,WSH,1,2,3,24,18,15,2,0,2,23,28,16
2023-24,3/14/2024,202403140TBL,New York Rangers,NYR,0,TBL,3,6,9,28,27,21,6,11,17,28,32,15
2023-24,3/14/2024,202403140BUF,New York Islanders,NYI,0,BUF,0,0,0,21,51,9,4,8,12,37,23,9
2023-24,3/14/2024,202403140CAR,Florida Panthers,FLA,0,CAR,0,0,0,21,41,10,4,6,10,35,26,10
2023-24,3/14/2024,202403140CBJ,Ottawa Senators,OTT,0,CBJ,2,4,6,37,12,22,2,4,6,37,14,23
2023-24,3/14/2024,202403140CGY,Vegas Golden Knights,VEG,0,CGY,1,1,2,29,20,19,4,7,11,37,19,30
2023-24,3/14/2024,202403140DAL,New Jersey Devils,NJD,0,DAL,6,9,15,20,22,23,2,4,6,37,27,7
2023-24,3/14/2024,202403140DET,Detroit Red Wings,DET,1,ARI,1,2,3,29,20,18,4,7,11,27,16,18
2023-24,3/14/2024,202403140MIN,Minnesota Wild,MIN,1,ANA,2,4,6,31,14,16,0,0,0,16,16,14
2023-24,3/14/2024,202403140MTL,Montreal Canadiens,MTL,1,BOS,1,1,2,19,17,19,2,4,6,24,20,18
2023-24,3/14/2024,202403140PHI,Toronto Maple Leafs,TOR,0,PHI,6,11,17,27,28,12,2,4,6,28,37,18
2023-24,3/14/2024,202403140PIT,San Jose Sharks,SJS,0,PIT,3,6,9,32,27,20,6,11,17,31,23,20
2023-24,3/14/2024,202403140SEA,Washington Capitals,WSH,0,SEA,2,0,2,23,28,16,1,2,3,24,18,15
2023-24,3/14/2024,202403140TBL,Tampa Bay Lightning,TBL,1,NYR,6,11,17,28,32,15,3,6,9,28,27,21
2023-24,3/13/2024,202403130EDM,Edmonton Oilers,EDM,1,WSH,7,13,20,37,19,11,2,2,4,25,33,13
2023-24,3/13/2024,202403130STL,Los Angeles Kings,LAK,0,STL,1,2,3,41,29,9,3,6,9,30,22,20
2023-24,3/13/2024,202403130VAN,Colorado Avalanche,COL,0,VAN,4,7,11,34,20,2,3,5,8,21,31,22
2023-24,3/13/2024,202403130WPG,Nashville Predators,NSH,0,WPG,4,6,10,38,28,9,2,4,6,29,42,10
2023-24,3/13/2024,202403130EDM,Washington Capitals,WSH,0,EDM,2,2,4,25,33,13,7,13,20,37,19,11
2023-24,3/13/2024,202403130STL,St. Louis Blues,STL,1,LAK,3,6,9,30,22,20,1,2,3,41,29,9
2023-24,3/13/2024,202403130VAN,Vancouver Canucks,VAN,1,COL,3,5,8,21,31,22,4,7,11,34,20,2
2023-24,3/13/2024,202403130WPG,Winnipeg Jets,WPG,1,NSH,2,4,6,29,42,10,4,6,10,38,28,9
2023-24,3/12/2024,202403120BUF,Buffalo Sabres,BUF,1,DET,7,9,16,39,22,9,3,6,9,24,42,17
2023-24,3/12/2024,202403120CAR,Carolina Hurricanes,CAR,1,NYR,0,0,0,28,28,13,1,2,3,24,23,23
2023-24,3/12/2024,202403120CGY,Calgary Flames,CGY,1,COL,2,4,6,27,19,19,6,11,17,38,24,15
2023-24,3/12/2024,202403120CHI,Anaheim Ducks,ANA,0,CHI,2,2,4,29,13,21,7,13,20,31,16,14
2023-24,3/12/2024,202403120DAL,Dallas Stars,DAL,1,FLA,3,5,8,30,30,9,4,8,12,30,44,13
2023-24,3/12/2024,202403120MIN,Arizona Coyotes,ARI,0,MIN,1,2,3,23,15,15,4,5,9,31,9,10
2023-24,3/12/2024,202403120MTL,Columbus Blue Jackets,CBJ,0,MTL,0,0,0,41,17,7,3,5,8,23,23,32
2023-24,3/12/2024,202403120OTT,Ottawa Senators,OTT,1,PIT,2,4,6,39,27,15,1,2,3,35,22,15
2023-24,3/12/2024,202403120PHI,Philadelphia Flyers,PHI,1,SJS,3,5,8,41,30,12,2,4,6,29,25,11
2023-24,3/12/2024,202403120SEA,Seattle Kraken,SEA,1,VEG,4,8,12,30,25,23,5,8,13,34,26,24
2023-24,3/12/2024,202403120BUF,Detroit Red Wings,DET,0,BUF,3,6,9,24,42,17,7,9,16,39,22,9
2023-24,3/12/2024,202403120CAR,New York Rangers,NYR,0,CAR,1,2,3,24,23,23,0,0,0,28,28,13
2023-24,3/12/2024,202403120CGY,Colorado Avalanche,COL,0,CGY,6,11,17,38,24,15,2,4,6,27,19,19
2023-24,3/12/2024,202403120CHI,Chicago Blackhawks,CHI,1,ANA,7,13,20,31,16,14,2,2,4,29,13,21
2023-24,3/12/2024,202403120DAL,Florida Panthers,FLA,0,DAL,4,8,12,30,44,13,3,5,8,30,30,9
2023-24,3/12/2024,202403120MIN,Minnesota Wild,MIN,1,ARI,4,5,9,31,9,10,1,2,3,23,15,15
2023-24,3/12/2024,202403120MTL,Montreal Canadiens,MTL,1,CBJ,3,5,8,23,23,32,0,0,0,41,17,7
2023-24,3/12/2024,202403120OTT,Pittsburgh Penguins,PIT,0,OTT,1,2,3,35,22,15,2,4,6,39,27,15
2023-24,3/12/2024,202403120PHI,San Jose Sharks,SJS,0,PHI,2,4,6,29,25,11,3,5,8,41,30,12
2023-24,3/12/2024,202403120SEA,Vegas Golden Knights,VEG,0,SEA,5,8,13,34,26,24,4,8,12,30,25,23
2023-24,3/11/2024,202403110BOS,Boston Bruins,BOS,1,STL,1,2,3,37,23,8,5,10,15,22,27,10
2023-24,3/11/2024,202403110LAK,Los Angeles Kings,LAK,1,NYI,3,4,7,25,29,16,0,0,0,26,26,15
2023-24,3/11/2024,202403110NYR,New Jersey Devils,NJD,0,NYR,1,2,3,20,21,16,3,4,7,26,20,16
2023-24,3/11/2024,202403110WPG,Winnipeg Jets,WPG,1,WSH,3,6,9,29,31,14,0,0,0,23,31,17
2023-24,3/11/2024,202403110BOS,St. Louis Blues,STL,0,BOS,5,10,15,22,27,10,1,2,3,37,23,8
2023-24,3/11/2024,202403110LAK,New York Islanders,NYI,0,LAK,0,0,0,26,26,15,3,4,7,25,29,16
2023-24,3/11/2024,202403110NYR,New York Rangers,NYR,1,NJD,3,4,7,26,20,16,1,2,3,20,21,16
2023-24,3/11/2024,202403110WPG,Washington Capitals,WSH,0,WPG,0,0,0,23,31,17,3,6,9,29,31,14
2023-24,3/10/2024,202403100ANA,Anaheim Ducks,ANA,1,NYI,1,2,3,23,17,15,6,9,15,19,20,13
2023-24,3/10/2024,202403100CAR,Carolina Hurricanes,CAR,1,CGY,7,13,20,40,21,14,2,2,4,20,31,22
2023-24,3/10/2024,202403100CHI,Arizona Coyotes,ARI,0,CHI,4,4,8,36,17,14,7,11,18,41,27,12
2023-24,3/10/2024,202403100MIN,Minnesota Wild,MIN,1,NSH,4,6,10,33,37,18,3,5,8,30,29,13
2023-24,3/10/2024,202403100PIT,Edmonton Oilers,EDM,0,PIT,4,5,9,42,4,17,0,0,0,41,16,15
2023-24,3/10/2024,202403100ANA,New York Islanders,NYI,0,ANA,6,9,15,19,20,13,1,2,3,23,17,15
2023-24,3/10/2024,202403100CAR,Calgary Flames,CGY,0,CAR,2,2,4,20,31,22,7,13,20,40,21,14
2023-24,3/10/2024,202403100CHI,Chicago Blackhawks,CHI,1,ARI,7,11,18,41,27,12,4,4,8,36,17,14
2023-24,3/10/2024,202403100MIN,Nashville Predators,NSH,0,MIN,3,5,8,30,29,13,4,6,10,33,37,18
2023-24,3/10/2024,202403100PIT,Pittsburgh Penguins,PIT,1,EDM,0,0,0,41,16,15,4,5,9,42,4,17
2023-24,3/9/2024,202403090BOS,Boston Bruins,BOS,1,PIT,5,10,15,23,34,16,1,1,2,39,30,8
2023-24,3/9/2024,202403090BUF,Buffalo Sabres,BUF,1,EDM,2,0,2,27,41,7,2,3,5,32,14,11
2023-24,3/9/2024,202403090CBJ,Columbus Blue Jackets,CBJ,1,NSH,1,1,2,34,23,12,2,2,4,49,18,17
2023-24,3/9/2024,202403090FLA,Calgary Flames,CGY,0,FLA,1,2,3,35,41,21,5,7,12,31,40,10
2023-24,3/9/2024,202403090LAK,Dallas Stars,DAL,0,LAK,4,6,10,35,16,7,1,1,2,25,23,16
2023-24,3/9/2024,202403090MTL,Montreal Canadiens,MTL,1,TOR,2,4,6,31,44,16,3,5,8,27,23,13
2023-24,3/9/2024,202403090NJD,Carolina Hurricanes,CAR,0,NJD,4,6,10,26,23,13,2,3,5,25,33,10
2023-24,3/9/2024,202403090NYR,New York Rangers,NYR,1,STL,4,7,11,39,17,11,0,0,0,26,32,16
2023-24,3/9/2024,202403090SJS,Ottawa Senators,OTT,0,SJS,1,2,3,32,16,17,2,4,6,21,12,19
2023-24,3/9/2024,202403090TBL,Philadelphia Flyers,PHI,0,TBL,0,0,0,25,46,15,7,13,20,26,16,20
2023-24,3/9/2024,202403090VAN,Vancouver Canucks,VAN,1,WPG,5,7,12,37,31,7,0,0,0,22,29,9
2023-24,3/9/2024,202403090VEG,Detroit Red Wings,DET,0,VEG,3,6,9,26,30,27,5,10,15,36,27,18
2023-24,3/9/2024,202403090WSH,Chicago Blackhawks,CHI,0,WSH,1,2,3,32,28,8,4,7,11,26,18,17
2023-24,3/9/2024,202403090BOS,Pittsburgh Penguins,PIT,0,BOS,1,1,2,39,30,8,5,10,15,23,34,16
2023-24,3/9/2024,202403090BUF,Edmonton Oilers,EDM,0,BUF,2,3,5,32,14,11,2,0,2,27,41,7
2023-24,3/9/2024,202403090CBJ,Nashville Predators,NSH,0,CBJ,2,2,4,49,18,17,1,1,2,34,23,12
2023-24,3/9/2024,202403090FLA,Florida Panthers,FLA,1,CGY,5,7,12,31,40,10,1,2,3,35,41,21
2023-24,3/9/2024,202403090LAK,Los Angeles Kings,LAK,1,DAL,1,1,2,25,23,16,4,6,10,35,16,7
2023-24,3/9/2024,202403090MTL,Toronto Maple Leafs,TOR,0,MTL,3,5,8,27,23,13,2,4,6,31,44,16
2023-24,3/9/2024,202403090NJD,New Jersey Devils,NJD,1,CAR,2,3,5,25,33,10,4,6,10,26,23,13
2023-24,3/9/2024,202403090NYR,St. Louis Blues,STL,0,NYR,0,0,0,26,32,16,4,7,11,39,17,11
2023-24,3/9/2024,202403090SJS,San Jose Sharks,SJS,1,OTT,2,4,6,21,12,19,1,2,3,32,16,17
2023-24,3/9/2024,202403090TBL,Tampa Bay Lightning,TBL,1,PHI,7,13,20,26,16,20,0,0,0,25,46,15
2023-24,3/9/2024,202403090VAN,Winnipeg Jets,WPG,0,VAN,0,0,0,22,29,9,5,7,12,37,31,7
2023-24,3/9/2024,202403090VEG,Vegas Golden Knights,VEG,1,DET,5,10,15,36,27,18,3,6,9,26,30,27
2023-24,3/9/2024,202403090WSH,Washington Capitals,WSH,1,CHI,4,7,11,26,18,17,1,2,3,32,28,8
2023-24,3/8/2024,202403080ANA,Anaheim Ducks,ANA,1,DAL,2,4,6,27,25,14,6,11,17,36,19,15
2023-24,3/8/2024,202403080ARI,Arizona Coyotes,ARI,1,DET,4,7,11,24,25,12,0,0,0,28,45,11
2023-24,3/8/2024,202403080COL,Colorado Avalanche,COL,1,MIN,2,3,5,40,27,13,1,2,3,30,18,24
2023-24,3/8/2024,202403080SEA,Seattle Kraken,SEA,1,WPG,0,0,0,17,20,6,3,6,9,32,24,19
2023-24,3/8/2024,202403080ANA,Dallas Stars,DAL,0,ANA,6,11,17,36,19,15,2,4,6,27,25,14
2023-24,3/8/2024,202403080ARI,Detroit Red Wings,DET,0,ARI,0,0,0,28,45,11,4,7,11,24,25,12
2023-24,3/8/2024,202403080COL,Minnesota Wild,MIN,0,COL,1,2,3,30,18,24,2,3,5,40,27,13
2023-24,3/8/2024,202403080SEA,Winnipeg Jets,WPG,0,SEA,3,6,9,32,24,19,0,0,0,17,20,6
2023-24,3/7/2024,202403070ARI,Arizona Coyotes,ARI,1,MIN,2,4,6,25,30,15,5,9,14,28,31,24
2023-24,3/7/2024,202403070BOS,Boston Bruins,BOS,1,TOR,4,6,10,25,45,15,1,1,2,29,43,12
2023-24,3/7/2024,202403070CAR,Carolina Hurricanes,CAR,1,MTL,4,7,11,39,13,10,1,1,2,25,15,24
2023-24,3/7/2024,202403070CBJ,Columbus Blue Jackets,CBJ,1,EDM,4,5,9,34,22,11,2,4,6,31,19,15
2023-24,3/7/2024,202403070FLA,Florida Panthers,FLA,1,PHI,1,2,3,30,39,18,2,4,6,26,38,29
2023-24,3/7/2024,202403070LAK,Los Angeles Kings,LAK,1,OTT,4,7,11,35,31,23,3,6,9,31,17,19
2023-24,3/7/2024,202403070NJD,New Jersey Devils,NJD,1,STL,4,8,12,33,12,17,1,2,3,24,9,15
2023-24,3/7/2024,202403070NSH,Buffalo Sabres,BUF,0,NSH,2,3,5,28,16,8,4,8,12,24,17,15
2023-24,3/7/2024,202403070PIT,Pittsburgh Penguins,PIT,1,WSH,0,0,0,39,23,13,6,10,16,29,13,20
2023-24,3/7/2024,202403070SJS,New York Islanders,NYI,0,SJS,7,11,18,33,6,15,2,3,5,25,17,19
2023-24,3/7/2024,202403070TBL,Calgary Flames,CGY,0,TBL,6,10,16,24,29,21,3,6,9,22,32,9
2023-24,3/7/2024,202403070VEG,Vancouver Canucks,VAN,0,VEG,3,5,8,35,25,16,1,2,3,28,28,11
2023-24,3/7/2024,202403070ARI,Minnesota Wild,MIN,0,ARI,5,9,14,28,31,24,2,4,6,25,30,15
2023-24,3/7/2024,202403070BOS,Toronto Maple Leafs,TOR,0,BOS,1,1,2,29,43,12,4,6,10,25,45,15
2023-24,3/7/2024,202403070CAR,Montreal Canadiens,MTL,0,CAR,1,1,2,25,15,24,4,7,11,39,13,10
2023-24,3/7/2024,202403070CBJ,Edmonton Oilers,EDM,0,CBJ,2,4,6,31,19,15,4,5,9,34,22,11
2023-24,3/7/2024,202403070FLA,Philadelphia Flyers,PHI,0,FLA,2,4,6,26,38,29,1,2,3,30,39,18
2023-24,3/7/2024,202403070LAK,Ottawa Senators,OTT,0,LAK,3,6,9,31,17,19,4,7,11,35,31,23
2023-24,3/7/2024,202403070NJD,St. Louis Blues,STL,0,NJD,1,2,3,24,9,15,4,8,12,33,12,17
2023-24,3/7/2024,202403070NSH,Nashville Predators,NSH,1,BUF,4,8,12,24,17,15,2,3,5,28,16,8
2023-24,3/7/2024,202403070PIT,Washington Capitals,WSH,0,PIT,6,10,16,29,13,20,0,0,0,39,23,13
2023-24,3/7/2024,202403070SJS,San Jose Sharks,SJS,1,NYI,2,3,5,25,17,19,7,11,18,33,6,15
2023-24,3/7/2024,202403070TBL,Tampa Bay Lightning,TBL,1,CGY,3,6,9,22,32,9,6,10,16,24,29,21
2023-24,3/7/2024,202403070VEG,Vegas Golden Knights,VEG,1,VAN,1,2,3,28,28,11,3,5,8,35,25,16
2023-24,3/6/2024,202403060ANA,Anaheim Ducks,ANA,1,OTT,2,4,6,16,36,19,1,2,3,30,15,14
2023-24,3/6/2024,202403060COL,Colorado Avalanche,COL,1,DET,7,13,20,54,11,11,2,4,6,29,27,22
2023-24,3/6/2024,202403060TOR,Buffalo Sabres,BUF,0,TOR,1,1,2,25,34,8,2,4,6,27,38,17
2023-24,3/6/2024,202403060ANA,Ottawa Senators,OTT,0,ANA,1,2,3,30,15,14,2,4,6,16,36,19
2023-24,3/6/2024,202403060COL,Detroit Red Wings,DET,0,COL,2,4,6,29,27,22,7,13,20,54,11,11
2023-24,3/6/2024,202403060TOR,Toronto Maple Leafs,TOR,1,BUF,2,4,6,27,38,17,1,1,2,25,34,8
2023-24,3/5/2024,202403050ARI,Arizona Coyotes,ARI,1,CHI,2,1,3,39,30,18,5,9,14,32,26,14
2023-24,3/5/2024,202403050BOS,Boston Bruins,BOS,1,EDM,1,2,3,25,27,27,2,4,6,26,29,11
2023-24,3/5/2024,202403050LAK,Los Angeles Kings,LAK,1,VAN,1,1,2,24,27,19,2,4,6,31,31,12
2023-24,3/5/2024,202403050NJD,Florida Panthers,FLA,0,NJD,5,8,13,31,14,19,3,4,7,24,21,13
2023-24,3/5/2024,202403050NSH,Montreal Canadiens,MTL,0,NSH,4,6,10,30,21,15,3,6,9,28,16,18
2023-24,3/5/2024,202403050NYI,New York Islanders,NYI,1,STL,4,8,12,33,20,13,2,3,5,21,16,17
2023-24,3/5/2024,202403050PIT,Columbus Blue Jackets,CBJ,0,PIT,3,5,8,35,18,25,5,6,11,31,18,20
2023-24,3/5/2024,202403050SJS,Dallas Stars,DAL,0,SJS,7,13,20,40,11,14,6,11,17,20,23,18
2023-24,3/5/2024,202403050WPG,Seattle Kraken,SEA,0,WPG,4,8,12,24,33,20,3,6,9,33,21,12
2023-24,3/5/2024,202403050ARI,Chicago Blackhawks,CHI,0,ARI,5,9,14,32,26,14,2,1,3,39,30,18
2023-24,3/5/2024,202403050BOS,Edmonton Oilers,EDM,0,BOS,2,4,6,26,29,11,1,2,3,25,27,27
2023-24,3/5/2024,202403050LAK,Vancouver Canucks,VAN,0,LAK,2,4,6,31,31,12,1,1,2,24,27,19
2023-24,3/5/2024,202403050NJD,New Jersey Devils,NJD,1,FLA,3,4,7,24,21,13,5,8,13,31,14,19
2023-24,3/5/2024,202403050NSH,Nashville Predators,NSH,1,MTL,3,6,9,28,16,18,4,6,10,30,21,15
2023-24,3/5/2024,202403050NYI,St. Louis Blues,STL,0,NYI,2,3,5,21,16,17,4,8,12,33,20,13
2023-24,3/5/2024,202403050PIT,Pittsburgh Penguins,PIT,1,CBJ,5,6,11,31,18,20,3,5,8,35,18,25
2023-24,3/5/2024,202403050SJS,San Jose Sharks,SJS,1,DAL,6,11,17,20,23,18,7,13,20,40,11,14
2023-24,3/5/2024,202403050WPG,Winnipeg Jets,WPG,1,SEA,3,6,9,33,21,12,4,8,12,24,33,20
2023-24,3/4/2024,202403040CBJ,Columbus Blue Jackets,CBJ,1,VEG,6,10,16,33,25,16,3,5,8,39,14,16
2023-24,3/4/2024,202403040CGY,Calgary Flames,CGY,1,SEA,2,4,6,37,20,21,4,6,10,30,22,24
2023-24,3/4/2024,202403040COL,Chicago Blackhawks,CHI,0,COL,0,0,0,37,21,11,5,10,15,37,20,16
2023-24,3/4/2024,202403040NYR,Florida Panthers,FLA,0,NYR,4,6,10,30,22,16,2,4,6,28,30,16
2023-24,3/4/2024,202403040PHI,Philadelphia Flyers,PHI,1,STL,1,2,3,42,14,29,1,1,2,25,16,14
2023-24,3/4/2024,202403040TOR,Boston Bruins,BOS,0,TOR,4,8,12,27,43,10,1,2,3,33,46,13
2023-24,3/4/2024,202403040CBJ,Vegas Golden Knights,VEG,0,CBJ,3,5,8,39,14,16,6,10,16,33,25,16
2023-24,3/4/2024,202403040CGY,Seattle Kraken,SEA,0,CGY,4,6,10,30,22,24,2,4,6,37,20,21
2023-24,3/4/2024,202403040COL,Colorado Avalanche,COL,1,CHI,5,10,15,37,20,16,0,0,0,37,21,11
2023-24,3/4/2024,202403040NYR,New York Rangers,NYR,1,FLA,2,4,6,28,30,16,4,6,10,30,22,16
2023-24,3/4/2024,202403040PHI,St. Louis Blues,STL,0,PHI,1,1,2,25,16,14,1,2,3,42,14,29
2023-24,3/4/2024,202403040TOR,Toronto Maple Leafs,TOR,1,BOS,1,2,3,33,46,13,4,8,12,27,43,10
2023-24,3/3/2024,202403030ANA,Anaheim Ducks,ANA,1,VAN,1,2,3,18,27,20,2,4,6,31,17,15
2023-24,3/3/2024,202403030BUF,Buffalo Sabres,BUF,1,WPG,2,4,6,19,22,22,5,8,13,35,23,19
2023-24,3/3/2024,202403030EDM,Edmonton Oilers,EDM,1,PIT,6,12,18,37,29,10,1,2,3,23,29,17
2023-24,3/3/2024,202403030LAK,Los Angeles Kings,LAK,1,NJD,5,9,14,23,15,20,1,1,2,31,25,13
2023-24,3/3/2024,202403030MIN,Minnesota Wild,MIN,1,SJS,4,6,10,32,17,12,3,0,3,15,31,13
2023-24,3/3/2024,202403030WSH,Arizona Coyotes,ARI,0,WSH,5,9,14,28,18,11,2,3,5,26,23,24
2023-24,3/3/2024,202403030ANA,Vancouver Canucks,VAN,0,ANA,2,4,6,31,17,15,1,2,3,18,27,20
2023-24,3/3/2024,202403030BUF,Winnipeg Jets,WPG,0,BUF,5,8,13,35,23,19,2,4,6,19,22,22
2023-24,3/3/2024,202403030EDM,Pittsburgh Penguins,PIT,0,EDM,1,2,3,23,29,17,6,12,18,37,29,10
2023-24,3/3/2024,202403030LAK,New Jersey Devils,NJD,0,LAK,1,1,2,31,25,13,5,9,14,23,15,20
2023-24,3/3/2024,202403030MIN,San Jose Sharks,SJS,0,MIN,3,0,3,15,31,13,4,6,10,32,17,12
2023-24,3/3/2024,202403030WSH,Washington Capitals,WSH,1,ARI,2,3,5,26,23,24,5,9,14,28,18,11
2023-24,3/2/2024,202403020BUF,Buffalo Sabres,BUF,1,VEG,7,9,16,35,29,10,2,4,6,24,37,27
2023-24,3/2/2024,202403020CAR,Carolina Hurricanes,CAR,1,WPG,3,6,9,35,8,11,5,7,12,32,20,11
2023-24,3/2/2024,202403020CGY,Calgary Flames,CGY,1,PIT,4,5,9,20,35,12,3,4,7,30,18,21
2023-24,3/2/2024,202403020CHI,Columbus Blue Jackets,CBJ,0,CHI,5,6,11,31,13,14,2,4,6,28,21,21
2023-24,3/2/2024,202403020DAL,Dallas Stars,DAL,1,SJS,2,4,6,38,21,17,2,3,5,23,37,22
2023-24,3/2/2024,202403020DET,Detroit Red Wings,DET,1,FLA,0,0,0,21,25,22,4,8,12,37,40,14
2023-24,3/2/2024,202403020NSH,Colorado Avalanche,COL,0,NSH,1,2,3,26,19,21,5,8,13,35,20,13
2023-24,3/2/2024,202403020NYI,Boston Bruins,BOS,0,NYI,1,2,3,23,37,11,5,10,15,26,12,12
2023-24,3/2/2024,202403020PHI,Ottawa Senators,OTT,0,PHI,2,4,6,26,25,13,4,2,6,40,27,28
2023-24,3/2/2024,202403020SEA,Edmonton Oilers,EDM,0,SEA,2,3,5,24,8,21,1,2,3,25,20,13
2023-24,3/2/2024,202403020STL,Minnesota Wild,MIN,0,STL,1,0,1,22,24,13,3,5,8,27,21,22
2023-24,3/2/2024,202403020TBL,Montreal Canadiens,MTL,0,TBL,3,5,8,31,24,13,3,3,6,29,25,16
2023-24,3/2/2024,202403020TOR,New York Rangers,NYR,0,TOR,3,5,8,35,45,13,3,5,8,34,35,11
2023-24,3/2/2024,202403020BUF,Vegas Golden Knights,VEG,0,BUF,2,4,6,24,37,27,7,9,16,35,29,10
2023-24,3/2/2024,202403020CAR,Winnipeg Jets,WPG,0,CAR,5,7,12,32,20,11,3,6,9,35,8,11
2023-24,3/2/2024,202403020CGY,Pittsburgh Penguins,PIT,0,CGY,3,4,7,30,18,21,4,5,9,20,35,12
2023-24,3/2/2024,202403020CHI,Chicago Blackhawks,CHI,1,CBJ,2,4,6,28,21,21,5,6,11,31,13,14
2023-24,3/2/2024,202403020DAL,San Jose Sharks,SJS,0,DAL,2,3,5,23,37,22,2,4,6,38,21,17
2023-24,3/2/2024,202403020DET,Florida Panthers,FLA,0,DET,4,8,12,37,40,14,0,0,0,21,25,22
2023-24,3/2/2024,202403020NSH,Nashville Predators,NSH,1,COL,5,8,13,35,20,13,1,2,3,26,19,21
2023-24,3/2/2024,202403020NYI,New York Islanders,NYI,1,BOS,5,10,15,26,12,12,1,2,3,23,37,11
2023-24,3/2/2024,202403020PHI,Philadelphia Flyers,PHI,1,OTT,4,2,6,40,27,28,2,4,6,26,25,13
2023-24,3/2/2024,202403020SEA,Seattle Kraken,SEA,1,EDM,1,2,3,25,20,13,2,3,5,24,8,21
2023-24,3/2/2024,202403020STL,St. Louis Blues,STL,1,MIN,3,5,8,27,21,22,1,0,1,22,24,13
2023-24,3/2/2024,202403020TBL,Tampa Bay Lightning,TBL,1,MTL,3,3,6,29,25,16,3,5,8,31,24,13
2023-24,3/2/2024,202403020TOR,Toronto Maple Leafs,TOR,1,NYR,3,5,8,34,35,11,3,5,8,35,45,13
2023-24,3/1/2024,202403010ANA,Anaheim Ducks,ANA,1,NJD,4,6,10,23,28,21,3,6,9,55,11,10
2023-24,3/1/2024,202403010OTT,Arizona Coyotes,ARI,0,OTT,5,8,13,30,36,14,3,6,9,37,33,14
2023-24,3/1/2024,202403010WSH,Philadelphia Flyers,PHI,0,WSH,2,4,6,23,30,12,5,10,15,21,27,19
2023-24,3/1/2024,202403010ANA,New Jersey Devils,NJD,0,ANA,3,6,9,55,11,10,4,6,10,23,28,21
2023-24,3/1/2024,202403010OTT,Ottawa Senators,OTT,1,ARI,3,6,9,37,33,14,5,8,13,30,36,14
2023-24,3/1/2024,202403010WSH,Washington Capitals,WSH,1,PHI,5,10,15,21,27,19,2,4,6,23,30,12
2023-24,2/29/2024,202402290BOS,Boston Bruins,BOS,1,VEG,5,9,14,32,34,14,4,7,11,36,31,21
2023-24,2/29/2024,202402290CBJ,Carolina Hurricanes,CAR,0,CBJ,4,6,10,33,5,11,2,4,6,22,12,22
2023-24,2/29/2024,202402290CHI,Chicago Blackhawks,CHI,1,COL,0,0,0,24,18,17,5,8,13,33,20,10
2023-24,2/29/2024,202402290DAL,Dallas Stars,DAL,1,WPG,4,5,9,36,29,9,1,2,3,26,36,15
2023-24,2/29/2024,202402290DET,Detroit Red Wings,DET,1,NYI,3,6,9,25,15,11,5,6,11,27,19,21
2023-24,2/29/2024,202402290FLA,Florida Panthers,FLA,1,MTL,3,5,8,35,29,10,3,5,8,31,25,19
2023-24,2/29/2024,202402290NSH,Minnesota Wild,MIN,0,NSH,1,2,3,34,20,9,6,9,15,31,20,10
2023-24,2/29/2024,202402290SEA,Pittsburgh Penguins,PIT,0,SEA,0,0,0,33,16,11,2,4,6,28,14,22
2023-24,2/29/2024,202402290SJS,Anaheim Ducks,ANA,0,SJS,6,10,16,30,8,15,4,8,12,28,8,17
2023-24,2/29/2024,202402290TBL,Buffalo Sabres,BUF,0,TBL,3,3,6,23,31,11,2,4,6,23,28,20
2023-24,2/29/2024,202402290TOR,Arizona Coyotes,ARI,0,TOR,2,2,4,32,44,16,4,6,10,26,30,23
2023-24,2/29/2024,202402290VAN,Los Angeles Kings,LAK,0,VAN,5,9,14,20,24,23,1,2,3,24,33,6
2023-24,2/29/2024,202402290BOS,Vegas Golden Knights,VEG,0,BOS,4,7,11,36,31,21,5,9,14,32,34,14
2023-24,2/29/2024,202402290CBJ,Columbus Blue Jackets,CBJ,1,CAR,2,4,6,22,12,22,4,6,10,33,5,11
2023-24,2/29/2024,202402290CHI,Colorado Avalanche,COL,0,CHI,5,8,13,33,20,10,0,0,0,24,18,17
2023-24,2/29/2024,202402290DAL,Winnipeg Jets,WPG,0,DAL,1,2,3,26,36,15,4,5,9,36,29,9
2023-24,2/29/2024,202402290DET,New York Islanders,NYI,0,DET,5,6,11,27,19,21,3,6,9,25,15,11
2023-24,2/29/2024,202402290FLA,Montreal Canadiens,MTL,0,FLA,3,5,8,31,25,19,3,5,8,35,29,10
2023-24,2/29/2024,202402290NSH,Nashville Predators,NSH,1,MIN,6,9,15,31,20,10,1,2,3,34,20,9
2023-24,2/29/2024,202402290SEA,Seattle Kraken,SEA,1,PIT,2,4,6,28,14,22,0,0,0,33,16,11
2023-24,2/29/2024,202402290SJS,San Jose Sharks,SJS,1,ANA,4,8,12,28,8,17,6,10,16,30,8,15
2023-24,2/29/2024,202402290TBL,Tampa Bay Lightning,TBL,1,BUF,2,4,6,23,28,20,3,3,6,23,31,11
2023-24,2/29/2024,202402290TOR,Toronto Maple Leafs,TOR,1,ARI,4,6,10,26,30,23,2,2,4,32,44,16
2023-24,2/29/2024,202402290VAN,Vancouver Canucks,VAN,1,LAK,1,2,3,24,33,6,5,9,14,20,24,23
2023-24,2/28/2024,202402280EDM,Edmonton Oilers,EDM,1,STL,3,6,9,36,35,8,2,4,6,34,28,24
2023-24,2/28/2024,202402280NYR,Columbus Blue Jackets,CBJ,0,NYR,1,1,2,31,13,19,4,6,10,30,26,22
2023-24,2/28/2024,202402280EDM,St. Louis Blues,STL,0,EDM,2,4,6,34,28,24,3,6,9,36,35,8
2023-24,2/28/2024,202402280NYR,New York Rangers,NYR,1,CBJ,4,6,10,30,26,22,1,1,2,31,13,19
2023-24,2/27/2024,202402270CGY,Calgary Flames,CGY,1,LAK,4,6,10,37,30,14,2,4,6,23,20,22
2023-24,2/27/2024,202402270COL,Colorado Avalanche,COL,1,DAL,5,8,13,27,29,12,1,2,3,34,12,12
2023-24,2/27/2024,202402270DET,Detroit Red Wings,DET,1,WSH,8,14,22,31,12,23,3,3,6,21,14,14
2023-24,2/27/2024,202402270FLA,Buffalo Sabres,BUF,0,FLA,2,4,6,30,21,14,3,6,9,37,41,11
2023-24,2/27/2024,202402270MIN,Carolina Hurricanes,CAR,0,MIN,3,6,9,28,19,8,2,4,6,30,15,21
2023-24,2/27/2024,202402270MTL,Arizona Coyotes,ARI,0,MTL,2,4,6,38,18,12,4,6,10,21,22,24
2023-24,2/27/2024,202402270NSH,Nashville Predators,NSH,1,OTT,4,8,12,36,18,15,1,2,3,25,16,25
2023-24,2/27/2024,202402270PHI,Philadelphia Flyers,PHI,1,TBL,6,9,15,31,29,24,2,3,5,22,27,11
2023-24,2/27/2024,202402270SJS,New Jersey Devils,NJD,0,SJS,7,12,19,44,11,12,2,3,5,31,17,14
2023-24,2/27/2024,202402270TOR,Toronto Maple Leafs,TOR,1,VEG,2,3,5,30,32,17,6,9,15,32,39,23
2023-24,2/27/2024,202402270VAN,Pittsburgh Penguins,PIT,0,VAN,4,7,11,40,23,17,3,5,8,35,24,10
2023-24,2/27/2024,202402270WPG,St. Louis Blues,STL,0,WPG,2,2,4,38,15,15,4,6,10,32,25,17
2023-24,2/27/2024,202402270CGY,Los Angeles Kings,LAK,0,CGY,2,4,6,23,20,22,4,6,10,37,30,14
2023-24,2/27/2024,202402270COL,Dallas Stars,DAL,0,COL,1,2,3,34,12,12,5,8,13,27,29,12
2023-24,2/27/2024,202402270DET,Washington Capitals,WSH,0,DET,3,3,6,21,14,14,8,14,22,31,12,23
2023-24,2/27/2024,202402270FLA,Florida Panthers,FLA,1,BUF,3,6,9,37,41,11,2,4,6,30,21,14
2023-24,2/27/2024,202402270MIN,Minnesota Wild,MIN,1,CAR,2,4,6,30,15,21,3,6,9,28,19,8
2023-24,2/27/2024,202402270MTL,Montreal Canadiens,MTL,1,ARI,4,6,10,21,22,24,2,4,6,38,18,12
2023-24,2/27/2024,202402270NSH,Ottawa Senators,OTT,0,NSH,1,2,3,25,16,25,4,8,12,36,18,15
2023-24,2/27/2024,202402270PHI,Tampa Bay Lightning,TBL,0,PHI,2,3,5,22,27,11,6,9,15,31,29,24
2023-24,2/27/2024,202402270SJS,San Jose Sharks,SJS,1,NJD,2,3,5,31,17,14,7,12,19,44,11,12
2023-24,2/27/2024,202402270TOR,Vegas Golden Knights,VEG,0,TOR,6,9,15,32,39,23,2,3,5,30,32,17
2023-24,2/27/2024,202402270VAN,Vancouver Canucks,VAN,1,PIT,3,5,8,35,24,10,4,7,11,40,23,17
2023-24,2/27/2024,202402270WPG,Winnipeg Jets,WPG,1,STL,4,6,10,32,25,17,2,2,4,38,15,15
2023-24,2/26/2024,202402260DAL,Dallas Stars,DAL,1,NYI,2,3,5,32,28,19,3,6,9,28,36,26
2023-24,2/26/2024,202402260EDM,Edmonton Oilers,EDM,1,LAK,4,7,11,31,34,10,2,4,6,40,39,15
2023-24,2/26/2024,202402260SEA,Boston Bruins,BOS,0,SEA,3,6,9,32,9,21,3,4,7,27,19,16
2023-24,2/26/2024,202402260WSH,Ottawa Senators,OTT,0,WSH,3,6,9,21,29,7,6,11,17,20,27,28
2023-24,2/26/2024,202402260DAL,New York Islanders,NYI,0,DAL,3,6,9,28,36,26,2,3,5,32,28,19
2023-24,2/26/2024,202402260EDM,Los Angeles Kings,LAK,0,EDM,2,4,6,40,39,15,4,7,11,31,34,10
2023-24,2/26/2024,202402260SEA,Seattle Kraken,SEA,1,BOS,3,4,7,27,19,16,3,6,9,32,9,21
2023-24,2/26/2024,202402260WSH,Washington Capitals,WSH,1,OTT,6,11,17,20,27,28,3,6,9,21,29,7
2023-24,2/25/2024,202402250ANA,Anaheim Ducks,ANA,1,NSH,2,4,6,31,33,22,4,6,10,29,27,21
2023-24,2/25/2024,202402250BUF,Buffalo Sabres,BUF,1,CAR,2,4,6,32,23,23,2,4,6,32,14,25
2023-24,2/25/2024,202402250CBJ,Columbus Blue Jackets,CBJ,1,NYR,4,7,11,41,10,26,2,2,4,40,11,16
2023-24,2/25/2024,202402250CHI,Chicago Blackhawks,CHI,1,DET,2,4,6,36,20,22,3,5,8,31,11,12
2023-24,2/25/2024,202402250NJD,New Jersey Devils,NJD,1,TBL,1,2,3,19,9,8,4,7,11,27,15,25
2023-24,2/25/2024,202402250PIT,Philadelphia Flyers,PHI,0,PIT,6,11,17,21,24,24,7,12,19,32,23,18
2023-24,2/25/2024,202402250WPG,Arizona Coyotes,ARI,0,WPG,3,5,8,32,30,17,4,7,11,32,28,14
2023-24,2/25/2024,202402250ANA,Nashville Predators,NSH,0,ANA,4,6,10,29,27,21,2,4,6,31,33,22
2023-24,2/25/2024,202402250BUF,Carolina Hurricanes,CAR,0,BUF,2,4,6,32,14,25,2,4,6,32,23,23
2023-24,2/25/2024,202402250CBJ,New York Rangers,NYR,0,CBJ,2,2,4,40,11,16,4,7,11,41,10,26
2023-24,2/25/2024,202402250CHI,Detroit Red Wings,DET,0,CHI,3,5,8,31,11,12,2,4,6,36,20,22
2023-24,2/25/2024,202402250NJD,Tampa Bay Lightning,TBL,0,NJD,4,7,11,27,15,25,1,2,3,19,9,8
2023-24,2/25/2024,202402250PIT,Pittsburgh Penguins,PIT,1,PHI,7,12,19,32,23,18,6,11,17,21,24,24
2023-24,2/25/2024,202402250WPG,Winnipeg Jets,WPG,1,ARI,4,7,11,32,28,14,3,5,8,32,30,17
2023-24,2/24/2024,202402240CAR,Carolina Hurricanes,CAR,1,DAL,1,2,3,21,19,13,2,4,6,16,19,25
2023-24,2/24/2024,202402240COL,Colorado Avalanche,COL,1,TOR,3,6,9,29,21,15,4,8,12,30,22,24
2023-24,2/24/2024,202402240DET,Detroit Red Wings,DET,1,STL,6,9,15,34,23,6,1,2,3,23,21,13
2023-24,2/24/2024,202402240EDM,Calgary Flames,CGY,0,EDM,6,11,17,31,32,25,3,5,8,35,32,12
2023-24,2/24/2024,202402240FLA,Florida Panthers,FLA,1,WSH,3,5,8,29,41,9,2,4,6,24,34,24
2023-24,2/24/2024,202402240LAK,Anaheim Ducks,ANA,0,LAK,2,3,5,24,23,13,2,4,6,50,19,15
2023-24,2/24/2024,202402240NJD,Montreal Canadiens,MTL,0,NJD,3,6,9,26,21,18,4,6,10,24,11,10
2023-24,2/24/2024,202402240NYI,New York Islanders,NYI,1,TBL,2,3,5,34,16,20,4,8,12,21,19,12
2023-24,2/24/2024,202402240OTT,Ottawa Senators,OTT,1,VEG,3,6,9,33,34,22,3,5,8,29,32,19
2023-24,2/24/2024,202402240PHI,New York Rangers,NYR,0,PHI,2,4,6,24,35,18,1,2,3,40,23,20
2023-24,2/24/2024,202402240SEA,Minnesota Wild,MIN,0,SEA,5,10,15,31,9,22,2,3,5,32,27,11
2023-24,2/24/2024,202402240SJS,Nashville Predators,NSH,0,SJS,4,6,10,35,14,12,2,2,4,25,18,17
2023-24,2/24/2024,202402240VAN,Boston Bruins,BOS,0,VAN,2,3,5,25,24,18,3,6,9,39,45,11
2023-24,2/24/2024,202402240CAR,Dallas Stars,DAL,0,CAR,2,4,6,16,19,25,1,2,3,21,19,13
2023-24,2/24/2024,202402240COL,Toronto Maple Leafs,TOR,0,COL,4,8,12,30,22,24,3,6,9,29,21,15
2023-24,2/24/2024,202402240DET,St. Louis Blues,STL,0,DET,1,2,3,23,21,13,6,9,15,34,23,6
2023-24,2/24/2024,202402240EDM,Edmonton Oilers,EDM,1,CGY,3,5,8,35,32,12,6,11,17,31,32,25
2023-24,2/24/2024,202402240FLA,Washington Capitals,WSH,0,FLA,2,4,6,24,34,24,3,5,8,29,41,9
2023-24,2/24/2024,202402240LAK,Los Angeles Kings,LAK,1,ANA,2,4,6,50,19,15,2,3,5,24,23,13
2023-24,2/24/2024,202402240NJD,New Jersey Devils,NJD,1,MTL,4,6,10,24,11,10,3,6,9,26,21,18
2023-24,2/24/2024,202402240NYI,Tampa Bay Lightning,TBL,0,NYI,4,8,12,21,19,12,2,3,5,34,16,20
2023-24,2/24/2024,202402240OTT,Vegas Golden Knights,VEG,0,OTT,3,5,8,29,32,19,3,6,9,33,34,22
2023-24,2/24/2024,202402240PHI,Philadelphia Flyers,PHI,1,NYR,1,2,3,40,23,20,2,4,6,24,35,18
2023-24,2/24/2024,202402240SEA,Seattle Kraken,SEA,1,MIN,2,3,5,32,27,11,5,10,15,31,9,22
2023-24,2/24/2024,202402240SJS,San Jose Sharks,SJS,1,NSH,2,2,4,25,18,17,4,6,10,35,14,12
2023-24,2/24/2024,202402240VAN,Vancouver Canucks,VAN,1,BOS,3,6,9,39,45,11,2,3,5,25,24,18
2023-24,2/23/2024,202402230CBJ,Buffalo Sabres,BUF,0,CBJ,2,4,6,37,11,15,1,2,3,26,12,12
2023-24,2/23/2024,202402230CHI,Chicago Blackhawks,CHI,1,WPG,2,3,5,35,19,9,3,4,7,31,17,18
2023-24,2/23/2024,202402230EDM,Edmonton Oilers,EDM,1,MIN,2,4,6,43,26,19,4,6,10,20,28,16
2023-24,2/23/2024,202402230CBJ,Columbus Blue Jackets,CBJ,1,BUF,1,2,3,26,12,12,2,4,6,37,11,15
2023-24,2/23/2024,202402230CHI,Winnipeg Jets,WPG,0,CHI,3,4,7,31,17,18,2,3,5,35,19,9
2023-24,2/23/2024,202402230EDM,Minnesota Wild,MIN,0,EDM,4,6,10,20,28,16,2,4,6,43,26,19
2023-24,2/22/2024,202402220CAR,Carolina Hurricanes,CAR,1,FLA,1,2,3,29,28,9,0,0,0,45,38,19
2023-24,2/22/2024,202402220CGY,Boston Bruins,BOS,0,CGY,2,2,4,34,25,11,3,4,7,30,30,17
2023-24,2/22/2024,202402220DET,Colorado Avalanche,COL,0,DET,1,2,3,31,15,11,2,4,6,30,16,20
2023-24,2/22/2024,202402220LAK,Los Angeles Kings,LAK,1,NSH,1,2,3,28,23,12,4,6,10,21,23,18
2023-24,2/22/2024,202402220NJD,New Jersey Devils,NJD,1,NYR,1,1,2,40,19,7,5,5,10,18,33,30
2023-24,2/22/2024,202402220OTT,Dallas Stars,DAL,0,OTT,1,2,3,15,25,9,4,8,12,30,32,25
2023-24,2/22/2024,202402220PIT,Montreal Canadiens,MTL,0,PIT,1,0,1,31,10,9,4,6,10,27,22,20
2023-24,2/22/2024,202402220SEA,Seattle Kraken,SEA,1,VAN,5,7,12,31,9,16,2,4,6,21,12,12
2023-24,2/22/2024,202402220STL,New York Islanders,NYI,0,STL,0,0,0,38,25,11,4,7,11,25,11,9
2023-24,2/22/2024,202402220TBL,Tampa Bay Lightning,TBL,1,WSH,3,5,8,32,19,13,5,9,14,24,21,11
2023-24,2/22/2024,202402220VEG,Toronto Maple Leafs,TOR,0,VEG,7,9,16,42,30,22,3,6,9,26,32,21
2023-24,2/22/2024,202402220CAR,Florida Panthers,FLA,0,CAR,0,0,0,45,38,19,1,2,3,29,28,9
2023-24,2/22/2024,202402220CGY,Calgary Flames,CGY,1,BOS,3,4,7,30,30,17,2,2,4,34,25,11
2023-24,2/22/2024,202402220DET,Detroit Red Wings,DET,1,COL,2,4,6,30,16,20,1,2,3,31,15,11
2023-24,2/22/2024,202402220LAK,Nashville Predators,NSH,0,LAK,4,6,10,21,23,18,1,2,3,28,23,12
2023-24,2/22/2024,202402220NJD,New York Rangers,NYR,0,NJD,5,5,10,18,33,30,1,1,2,40,19,7
2023-24,2/22/2024,202402220OTT,Ottawa Senators,OTT,1,DAL,4,8,12,30,32,25,1,2,3,15,25,9
2023-24,2/22/2024,202402220PIT,Pittsburgh Penguins,PIT,1,MTL,4,6,10,27,22,20,1,0,1,31,10,9
2023-24,2/22/2024,202402220SEA,Vancouver Canucks,VAN,0,SEA,2,4,6,21,12,12,5,7,12,31,9,16
2023-24,2/22/2024,202402220STL,St. Louis Blues,STL,1,NYI,4,7,11,25,11,9,0,0,0,38,25,11
2023-24,2/22/2024,202402220TBL,Washington Capitals,WSH,0,TBL,5,9,14,24,21,11,3,5,8,32,19,13
2023-24,2/22/2024,202402220VEG,Vegas Golden Knights,VEG,1,TOR,3,6,9,26,32,21,7,9,16,42,30,22
2023-24,2/21/2024,202402210ANA,Anaheim Ducks,ANA,1,CBJ,4,8,12,31,28,10,7,11,18,27,22,10
2023-24,2/21/2024,202402210ARI,Arizona Coyotes,ARI,1,TOR,3,5,8,26,35,13,6,10,16,36,21,17
2023-24,2/21/2024,202402210CHI,Chicago Blackhawks,CHI,1,PHI,1,1,2,22,24,20,3,4,7,33,21,21
2023-24,2/21/2024,202402210EDM,Boston Bruins,BOS,0,EDM,6,11,17,36,32,24,5,8,13,42,23,9
2023-24,2/21/2024,202402210MTL,Buffalo Sabres,BUF,0,MTL,3,4,7,23,21,15,2,4,6,31,16,19
2023-24,2/21/2024,202402210ANA,Columbus Blue Jackets,CBJ,0,ANA,7,11,18,27,22,10,4,8,12,31,28,10
2023-24,2/21/2024,202402210ARI,Toronto Maple Leafs,TOR,0,ARI,6,10,16,36,21,17,3,5,8,26,35,13
2023-24,2/21/2024,202402210CHI,Philadelphia Flyers,PHI,0,CHI,3,4,7,33,21,21,1,1,2,22,24,20
2023-24,2/21/2024,202402210EDM,Edmonton Oilers,EDM,1,BOS,5,8,13,42,23,9,6,11,17,36,32,24
2023-24,2/21/2024,202402210MTL,Montreal Canadiens,MTL,1,BUF,2,4,6,31,16,19,3,4,7,23,21,15
2023-24,2/20/2024,202402200COL,Colorado Avalanche,COL,1,VAN,3,5,8,27,26,18,1,2,3,25,15,14
2023-24,2/20/2024,202402200FLA,Florida Panthers,FLA,1,OTT,3,4,7,34,33,9,2,2,4,30,26,29
2023-24,2/20/2024,202402200LAK,Columbus Blue Jackets,CBJ,0,LAK,1,2,3,33,27,8,5,7,12,35,15,19
2023-24,2/20/2024,202402200NYR,Dallas Stars,DAL,0,NYR,1,2,3,42,13,16,3,6,9,26,32,22
2023-24,2/20/2024,202402200PIT,New York Islanders,NYI,0,PIT,5,6,11,33,28,12,4,7,11,41,17,14
2023-24,2/20/2024,202402200VEG,Nashville Predators,NSH,0,VEG,5,8,13,40,40,8,3,6,9,26,30,19
2023-24,2/20/2024,202402200WPG,Minnesota Wild,MIN,0,WPG,3,5,8,39,27,17,6,11,17,30,26,14
2023-24,2/20/2024,202402200WSH,New Jersey Devils,NJD,0,WSH,2,3,5,39,17,16,6,9,15,26,17,15
2023-24,2/20/2024,202402200COL,Vancouver Canucks,VAN,0,COL,1,2,3,25,15,14,3,5,8,27,26,18
2023-24,2/20/2024,202402200FLA,Ottawa Senators,OTT,0,FLA,2,2,4,30,26,29,3,4,7,34,33,9
2023-24,2/20/2024,202402200LAK,Los Angeles Kings,LAK,1,CBJ,5,7,12,35,15,19,1,2,3,33,27,8
2023-24,2/20/2024,202402200NYR,New York Rangers,NYR,1,DAL,3,6,9,26,32,22,1,2,3,42,13,16
2023-24,2/20/2024,202402200PIT,Pittsburgh Penguins,PIT,1,NYI,4,7,11,41,17,14,5,6,11,33,28,12
2023-24,2/20/2024,202402200VEG,Vegas Golden Knights,VEG,1,NSH,3,6,9,26,30,19,5,8,13,40,40,8
2023-24,2/20/2024,202402200WPG,Winnipeg Jets,WPG,1,MIN,6,11,17,30,26,14,3,5,8,39,27,17
2023-24,2/20/2024,202402200WSH,Washington Capitals,WSH,1,NJD,6,9,15,26,17,15,2,3,5,39,17,16
2023-24,2/19/2024,202402190ARI,Arizona Coyotes,ARI,1,EDM,3,5,8,25,27,11,6,12,18,26,18,17
2023-24,2/19/2024,202402190BOS,Boston Bruins,BOS,1,DAL,3,6,9,30,27,18,3,4,7,46,30,13
2023-24,2/19/2024,202402190BUF,Anaheim Ducks,ANA,0,BUF,4,7,11,14,26,16,3,5,8,37,14,8
2023-24,2/19/2024,202402190CAR,Carolina Hurricanes,CAR,1,CHI,6,10,16,42,12,11,3,5,8,17,24,16
2023-24,2/19/2024,202402190CGY,Calgary Flames,CGY,1,WPG,6,8,14,34,29,11,3,6,9,31,27,17
2023-24,2/19/2024,202402190MIN,Minnesota Wild,MIN,1,VAN,10,16,26,27,21,23,7,12,19,24,22,17
2023-24,2/19/2024,202402190SEA,Detroit Red Wings,DET,0,SEA,4,7,11,32,9,17,3,6,9,41,17,15
2023-24,2/19/2024,202402190SJS,San Jose Sharks,SJS,1,VEG,0,0,0,29,33,22,4,7,11,26,20,25
2023-24,2/19/2024,202402190STL,St. Louis Blues,STL,1,TOR,2,4,6,21,19,7,4,5,9,29,23,26
2023-24,2/19/2024,202402190TBL,Ottawa Senators,OTT,0,TBL,4,7,11,28,32,26,2,1,3,25,37,21
2023-24,2/19/2024,202402190ARI,Edmonton Oilers,EDM,0,ARI,6,12,18,26,18,17,3,5,8,25,27,11
2023-24,2/19/2024,202402190BOS,Dallas Stars,DAL,0,BOS,3,4,7,46,30,13,3,6,9,30,27,18
2023-24,2/19/2024,202402190BUF,Buffalo Sabres,BUF,1,ANA,3,5,8,37,14,8,4,7,11,14,26,16
2023-24,2/19/2024,202402190CAR,Chicago Blackhawks,CHI,0,CAR,3,5,8,17,24,16,6,10,16,42,12,11
2023-24,2/19/2024,202402190CGY,Winnipeg Jets,WPG,0,CGY,3,6,9,31,27,17,6,8,14,34,29,11
2023-24,2/19/2024,202402190MIN,Vancouver Canucks,VAN,0,MIN,7,12,19,24,22,17,10,16,26,27,21,23
2023-24,2/19/2024,202402190SEA,Seattle Kraken,SEA,1,DET,3,6,9,41,17,15,4,7,11,32,9,17
2023-24,2/19/2024,202402190SJS,Vegas Golden Knights,VEG,0,SJS,4,7,11,26,20,25,0,0,0,29,33,22
2023-24,2/19/2024,202402190STL,Toronto Maple Leafs,TOR,0,STL,4,5,9,29,23,26,2,4,6,21,19,7
2023-24,2/19/2024,202402190TBL,Tampa Bay Lightning,TBL,1,OTT,2,1,3,25,37,21,4,7,11,28,32,26
2023-24,2/18/2024,202402180COL,Arizona Coyotes,ARI,0,COL,3,6,9,30,8,13,4,8,12,37,17,9
2023-24,2/18/2024,202402180NYI,New York Islanders,NYI,1,NYR,5,9,14,41,24,20,6,10,16,38,45,9
2023-24,2/18/2024,202402180PIT,Los Angeles Kings,LAK,0,PIT,2,3,5,34,21,17,1,2,3,30,34,16
2023-24,2/18/2024,202402180COL,Colorado Avalanche,COL,1,ARI,4,8,12,37,17,9,3,6,9,30,8,13
2023-24,2/18/2024,202402180NYI,New York Rangers,NYR,0,NYI,6,10,16,38,45,9,5,9,14,41,24,20
2023-24,2/18/2024,202402180PIT,Pittsburgh Penguins,PIT,1,LAK,1,2,3,30,34,16,2,3,5,34,21,17
2023-24,2/17/2024,202402170BOS,Boston Bruins,BOS,1,LAK,4,8,12,32,48,19,5,9,14,35,41,19
2023-24,2/17/2024,202402170CGY,Calgary Flames,CGY,1,DET,0,0,0,38,29,21,5,9,14,21,17,24
2023-24,2/17/2024,202402170CHI,Chicago Blackhawks,CHI,1,OTT,3,5,8,22,27,17,2,4,6,42,23,17
2023-24,2/17/2024,202402170DAL,Dallas Stars,DAL,1,EDM,3,6,9,27,25,14,4,6,10,24,32,18
2023-24,2/17/2024,202402170MIN,Buffalo Sabres,BUF,0,MIN,3,5,8,28,18,10,2,3,5,32,21,8
2023-24,2/17/2024,202402170MTL,Montreal Canadiens,MTL,1,WSH,3,5,8,31,18,26,4,8,12,34,13,16
2023-24,2/17/2024,202402170NJD,New Jersey Devils,NJD,1,PHI,6,12,18,40,23,15,3,6,9,48,41,26
2023-24,2/17/2024,202402170SJS,Columbus Blue Jackets,CBJ,0,SJS,4,8,12,41,16,14,3,4,7,31,24,15
2023-24,2/17/2024,202402170STL,Nashville Predators,NSH,0,STL,5,7,12,33,28,17,2,4,6,37,23,14
2023-24,2/17/2024,202402170TBL,Florida Panthers,FLA,0,TBL,9,15,24,30,35,14,2,3,5,30,35,10
2023-24,2/17/2024,202402170TOR,Anaheim Ducks,ANA,0,TOR,2,4,6,21,51,13,9,17,26,32,39,11
2023-24,2/17/2024,202402170VAN,Vancouver Canucks,VAN,1,WPG,2,2,4,37,38,10,4,8,12,28,26,18
2023-24,2/17/2024,202402170VEG,Carolina Hurricanes,CAR,0,VEG,3,6,9,28,20,15,1,2,3,30,29,18
2023-24,2/17/2024,202402170BOS,Los Angeles Kings,LAK,0,BOS,5,9,14,35,41,19,4,8,12,32,48,19
2023-24,2/17/2024,202402170CGY,Detroit Red Wings,DET,0,CGY,5,9,14,21,17,24,0,0,0,38,29,21
2023-24,2/17/2024,202402170CHI,Ottawa Senators,OTT,0,CHI,2,4,6,42,23,17,3,5,8,22,27,17
2023-24,2/17/2024,202402170DAL,Edmonton Oilers,EDM,0,DAL,4,6,10,24,32,18,3,6,9,27,25,14
2023-24,2/17/2024,202402170MIN,Minnesota Wild,MIN,1,BUF,2,3,5,32,21,8,3,5,8,28,18,10
2023-24,2/17/2024,202402170MTL,Washington Capitals,WSH,0,MTL,4,8,12,34,13,16,3,5,8,31,18,26
2023-24,2/17/2024,202402170NJD,Philadelphia Flyers,PHI,0,NJD,3,6,9,48,41,26,6,12,18,40,23,15
2023-24,2/17/2024,202402170SJS,San Jose Sharks,SJS,1,CBJ,3,4,7,31,24,15,4,8,12,41,16,14
2023-24,2/17/2024,202402170STL,St. Louis Blues,STL,1,NSH,2,4,6,37,23,14,5,7,12,33,28,17
2023-24,2/17/2024,202402170TBL,Tampa Bay Lightning,TBL,1,FLA,2,3,5,30,35,10,9,15,24,30,35,14
2023-24,2/17/2024,202402170TOR,Toronto Maple Leafs,TOR,1,ANA,9,17,26,32,39,11,2,4,6,21,51,13
2023-24,2/17/2024,202402170VAN,Winnipeg Jets,WPG,0,VAN,4,8,12,28,26,18,2,2,4,37,38,10
2023-24,2/17/2024,202402170VEG,Vegas Golden Knights,VEG,1,CAR,1,2,3,30,29,18,3,6,9,28,20,15
2023-24,2/16/2024,202402160ARI,Arizona Coyotes,ARI,1,CAR,1,0,1,31,30,14,5,7,12,30,14,10
2023-24,2/16/2024,202402160ARI,Carolina Hurricanes,CAR,0,ARI,5,7,12,30,14,10,1,0,1,31,30,14
2023-24,2/15/2024,202402150BOS,Boston Bruins,BOS,1,SEA,1,2,3,37,30,10,4,4,8,26,36,17
2023-24,2/15/2024,202402150BUF,Buffalo Sabres,BUF,1,FLA,0,0,0,45,21,15,4,7,11,30,47,8
2023-24,2/15/2024,202402150CGY,Calgary Flames,CGY,1,SJS,3,5,8,34,21,17,6,8,14,31,14,18
2023-24,2/15/2024,202402150CHI,Chicago Blackhawks,CHI,1,PIT,1,2,3,28,17,12,4,6,10,27,11,8
2023-24,2/15/2024,202402150NJD,Los Angeles Kings,LAK,0,NJD,2,3,5,29,22,13,1,2,3,27,20,21
2023-24,2/15/2024,202402150NSH,Dallas Stars,DAL,0,NSH,9,13,22,41,15,18,2,3,5,29,32,12
2023-24,2/15/2024,202402150NYR,Montreal Canadiens,MTL,0,NYR,4,7,11,36,18,10,7,14,21,31,29,17
2023-24,2/15/2024,202402150OTT,Anaheim Ducks,ANA,0,OTT,5,10,15,20,29,15,1,0,1,34,30,11
2023-24,2/15/2024,202402150STL,Edmonton Oilers,EDM,0,STL,3,6,9,38,12,14,6,10,16,30,13,15
2023-24,2/15/2024,202402150TBL,Colorado Avalanche,COL,0,TBL,3,6,9,31,26,15,6,9,15,39,27,17
2023-24,2/15/2024,202402150TOR,Philadelphia Flyers,PHI,0,TOR,3,6,9,32,50,20,4,6,10,28,53,19
2023-24,2/15/2024,202402150VAN,Detroit Red Wings,DET,0,VAN,1,2,3,28,17,17,4,4,8,21,18,14
2023-24,2/15/2024,202402150BOS,Seattle Kraken,SEA,0,BOS,4,4,8,26,36,17,1,2,3,37,30,10
2023-24,2/15/2024,202402150BUF,Florida Panthers,FLA,0,BUF,4,7,11,30,47,8,0,0,0,45,21,15
2023-24,2/15/2024,202402150CGY,San Jose Sharks,SJS,0,CGY,6,8,14,31,14,18,3,5,8,34,21,17
2023-24,2/15/2024,202402150CHI,Pittsburgh Penguins,PIT,0,CHI,4,6,10,27,11,8,1,2,3,28,17,12
2023-24,2/15/2024,202402150NJD,New Jersey Devils,NJD,1,LAK,1,2,3,27,20,21,2,3,5,29,22,13
2023-24,2/15/2024,202402150NSH,Nashville Predators,NSH,1,DAL,2,3,5,29,32,12,9,13,22,41,15,18
2023-24,2/15/2024,202402150NYR,New York Rangers,NYR,1,MTL,7,14,21,31,29,17,4,7,11,36,18,10
2023-24,2/15/2024,202402150OTT,Ottawa Senators,OTT,1,ANA,1,0,1,34,30,11,5,10,15,20,29,15
2023-24,2/15/2024,202402150STL,St. Louis Blues,STL,1,EDM,6,10,16,30,13,15,3,6,9,38,12,14
2023-24,2/15/2024,202402150TBL,Tampa Bay Lightning,TBL,1,COL,6,9,15,39,27,17,3,6,9,31,26,15
2023-24,2/15/2024,202402150TOR,Toronto Maple Leafs,TOR,1,PHI,4,6,10,28,53,19,3,6,9,32,50,20
2023-24,2/15/2024,202402150VAN,Vancouver Canucks,VAN,1,DET,4,4,8,21,18,14,1,2,3,28,17,17
2023-24,2/14/2024,202402140ARI,Arizona Coyotes,ARI,1,MIN,1,2,3,26,26,13,3,4,7,43,28,24
2023-24,2/14/2024,202402140PIT,Florida Panthers,FLA,0,PIT,5,9,14,23,20,15,2,4,6,27,20,16
2023-24,2/14/2024,202402140WPG,San Jose Sharks,SJS,0,WPG,0,0,0,17,15,24,1,2,3,39,16,14
2023-24,2/14/2024,202402140ARI,Minnesota Wild,MIN,0,ARI,3,4,7,43,28,24,1,2,3,26,26,13
2023-24,2/14/2024,202402140PIT,Pittsburgh Penguins,PIT,1,FLA,2,4,6,27,20,16,5,9,14,23,20,15
2023-24,2/14/2024,202402140WPG,Winnipeg Jets,WPG,1,SJS,1,2,3,39,16,14,0,0,0,17,15,24
2023-24,2/13/2024,202402130BOS,Boston Bruins,BOS,1,TBL,2,4,6,38,32,10,2,2,4,25,35,19
2023-24,2/13/2024,202402130BUF,Buffalo Sabres,BUF,1,LAK,7,10,17,24,14,25,0,0,0,33,24,10
2023-24,2/13/2024,202402130CHI,Chicago Blackhawks,CHI,1,VAN,2,4,6,24,18,10,4,7,11,38,20,10
2023-24,2/13/2024,202402130DAL,Carolina Hurricanes,CAR,0,DAL,2,4,6,34,26,12,4,7,11,23,34,30
2023-24,2/13/2024,202402130EDM,Detroit Red Wings,DET,0,EDM,4,8,12,38,23,13,8,14,22,36,27,13
2023-24,2/13/2024,202402130MTL,Anaheim Ducks,ANA,0,MTL,0,0,0,13,27,16,5,9,14,38,21,12
2023-24,2/13/2024,202402130NSH,New Jersey Devils,NJD,0,NSH,4,7,11,47,22,17,2,4,6,32,38,27
2023-24,2/13/2024,202402130NYI,New York Islanders,NYI,1,SEA,1,2,3,27,29,26,1,1,2,30,24,17
2023-24,2/13/2024,202402130OTT,Columbus Blue Jackets,CBJ,0,OTT,3,6,9,40,31,11,6,7,13,30,24,18
2023-24,2/13/2024,202402130TOR,St. Louis Blues,STL,0,TOR,1,2,3,15,38,10,4,5,9,32,43,16
2023-24,2/13/2024,202402130WSH,Colorado Avalanche,COL,0,WSH,6,11,17,37,17,17,3,5,8,27,26,17
2023-24,2/13/2024,202402130BOS,Tampa Bay Lightning,TBL,0,BOS,2,2,4,25,35,19,2,4,6,38,32,10
2023-24,2/13/2024,202402130BUF,Los Angeles Kings,LAK,0,BUF,0,0,0,33,24,10,7,10,17,24,14,25
2023-24,2/13/2024,202402130CHI,Vancouver Canucks,VAN,0,CHI,4,7,11,38,20,10,2,4,6,24,18,10
2023-24,2/13/2024,202402130DAL,Dallas Stars,DAL,1,CAR,4,7,11,23,34,30,2,4,6,34,26,12
2023-24,2/13/2024,202402130EDM,Edmonton Oilers,EDM,1,DET,8,14,22,36,27,13,4,8,12,38,23,13
2023-24,2/13/2024,202402130MTL,Montreal Canadiens,MTL,1,ANA,5,9,14,38,21,12,0,0,0,13,27,16
2023-24,2/13/2024,202402130NSH,Nashville Predators,NSH,1,NJD,2,4,6,32,38,27,4,7,11,47,22,17
2023-24,2/13/2024,202402130NYI,Seattle Kraken,SEA,0,NYI,1,1,2,30,24,17,1,2,3,27,29,26
2023-24,2/13/2024,202402130OTT,Ottawa Senators,OTT,1,CBJ,6,7,13,30,24,18,3,6,9,40,31,11
2023-24,2/13/2024,202402130TOR,Toronto Maple Leafs,TOR,1,STL,4,5,9,32,43,16,1,2,3,15,38,10
2023-24,2/13/2024,202402130WSH,Washington Capitals,WSH,1,COL,3,5,8,27,26,17,6,11,17,37,17,17
2023-24,2/12/2024,202402120NJD,New Jersey Devils,NJD,1,SEA,3,5,8,37,17,18,1,2,3,28,30,13
2023-24,2/12/2024,202402120NYR,Calgary Flames,CGY,0,NYR,0,0,0,29,26,19,2,2,4,31,30,15
2023-24,2/12/2024,202402120PHI,Arizona Coyotes,ARI,0,PHI,3,6,9,23,20,15,5,6,11,34,20,13
2023-24,2/12/2024,202402120VEG,Minnesota Wild,MIN,0,VEG,5,8,13,29,22,11,3,6,9,30,19,19
2023-24,2/12/2024,202402120NJD,Seattle Kraken,SEA,0,NJD,1,2,3,28,30,13,3,5,8,37,17,18
2023-24,2/12/2024,202402120NYR,New York Rangers,NYR,1,CGY,2,2,4,31,30,15,0,0,0,29,26,19
2023-24,2/12/2024,202402120PHI,Philadelphia Flyers,PHI,1,ARI,5,6,11,34,20,13,3,6,9,23,20,15
2023-24,2/12/2024,202402120VEG,Vegas Golden Knights,VEG,1,MIN,3,6,9,30,19,19,5,8,13,29,22,11
2023-24,2/11/2024,202402110MTL,Montreal Canadiens,MTL,1,STL,2,4,6,32,22,9,7,13,20,36,11,17
2023-24,2/11/2024,202402110WSH,Vancouver Canucks,VAN,0,WSH,3,3,6,29,30,19,2,4,6,33,21,23
2023-24,2/11/2024,202402110MTL,St. Louis Blues,STL,0,MTL,7,13,20,36,11,17,2,4,6,32,22,9
2023-24,2/11/2024,202402110WSH,Washington Capitals,WSH,1,VAN,2,4,6,33,21,23,3,3,6,29,30,19
2023-24,2/10/2024,202402100BOS,Boston Bruins,BOS,1,WSH,0,0,0,18,36,11,3,5,8,29,31,11
2023-24,2/10/2024,202402100BUF,Buffalo Sabres,BUF,1,STL,1,0,1,35,14,11,3,6,9,26,26,16
2023-24,2/10/2024,202402100CAR,Carolina Hurricanes,CAR,1,NJD,1,2,3,32,30,15,0,0,0,34,26,24
2023-24,2/10/2024,202402100CBJ,Columbus Blue Jackets,CBJ,1,TBL,2,4,6,35,18,14,4,8,12,37,8,17
2023-24,2/10/2024,202402100DET,Detroit Red Wings,DET,1,VAN,4,6,10,28,17,20,3,6,9,31,25,16
2023-24,2/10/2024,202402100FLA,Colorado Avalanche,COL,0,FLA,0,0,0,34,23,21,4,6,10,41,35,10
2023-24,2/10/2024,202402100LAK,Edmonton Oilers,EDM,0,LAK,0,0,0,26,23,5,4,7,11,26,31,25
2023-24,2/10/2024,202402100MTL,Dallas Stars,DAL,0,MTL,3,6,9,38,5,16,2,4,6,20,28,17
2023-24,2/10/2024,202402100NSH,Arizona Coyotes,ARI,0,NSH,4,8,12,31,26,27,5,9,14,37,26,12
2023-24,2/10/2024,202402100NYI,Calgary Flames,CGY,0,NYI,5,7,12,24,12,19,2,3,5,36,25,16
2023-24,2/10/2024,202402100OTT,Ottawa Senators,OTT,1,TOR,5,7,12,32,23,13,3,6,9,35,20,15
2023-24,2/10/2024,202402100PHI,Philadelphia Flyers,PHI,1,SEA,3,6,9,38,28,23,2,4,6,19,25,22
2023-24,2/10/2024,202402100WPG,Pittsburgh Penguins,PIT,0,WPG,1,2,3,36,19,15,2,3,5,31,26,11
2023-24,2/10/2024,202402100BOS,Washington Capitals,WSH,0,BOS,3,5,8,29,31,11,0,0,0,18,36,11
2023-24,2/10/2024,202402100BUF,St. Louis Blues,STL,0,BUF,3,6,9,26,26,16,1,0,1,35,14,11
2023-24,2/10/2024,202402100CAR,New Jersey Devils,NJD,0,CAR,0,0,0,34,26,24,1,2,3,32,30,15
2023-24,2/10/2024,202402100CBJ,Tampa Bay Lightning,TBL,0,CBJ,4,8,12,37,8,17,2,4,6,35,18,14
2023-24,2/10/2024,202402100DET,Vancouver Canucks,VAN,0,DET,3,6,9,31,25,16,4,6,10,28,17,20
2023-24,2/10/2024,202402100FLA,Florida Panthers,FLA,1,COL,4,6,10,41,35,10,0,0,0,34,23,21
2023-24,2/10/2024,202402100LAK,Los Angeles Kings,LAK,1,EDM,4,7,11,26,31,25,0,0,0,26,23,5
2023-24,2/10/2024,202402100MTL,Montreal Canadiens,MTL,1,DAL,2,4,6,20,28,17,3,6,9,38,5,16
2023-24,2/10/2024,202402100NSH,Nashville Predators,NSH,1,ARI,5,9,14,37,26,12,4,8,12,31,26,27
2023-24,2/10/2024,202402100NYI,New York Islanders,NYI,1,CGY,2,3,5,36,25,16,5,7,12,24,12,19
2023-24,2/10/2024,202402100OTT,Toronto Maple Leafs,TOR,0,OTT,3,6,9,35,20,15,5,7,12,32,23,13
2023-24,2/10/2024,202402100PHI,Seattle Kraken,SEA,0,PHI,2,4,6,19,25,22,3,6,9,38,28,23
2023-24,2/10/2024,202402100WPG,Winnipeg Jets,WPG,1,PIT,2,3,5,31,26,11,1,2,3,36,19,15
2023-24,2/9/2024,202402090ANA,Anaheim Ducks,ANA,1,EDM,3,6,9,27,25,13,5,8,13,32,18,12
2023-24,2/9/2024,202402090CHI,Chicago Blackhawks,CHI,1,NYR,3,4,7,31,17,12,4,8,12,35,19,15
2023-24,2/9/2024,202402090MIN,Minnesota Wild,MIN,1,PIT,3,6,9,30,19,21,2,3,5,36,16,17
2023-24,2/9/2024,202402090ANA,Edmonton Oilers,EDM,0,ANA,5,8,13,32,18,12,3,6,9,27,25,13
2023-24,2/9/2024,202402090CHI,New York Rangers,NYR,0,CHI,4,8,12,35,19,15,3,4,7,31,17,12
2023-24,2/9/2024,202402090MIN,Pittsburgh Penguins,PIT,0,MIN,2,3,5,36,16,17,3,6,9,30,19,21
2023-24,2/8/2024,202402080ARI,Arizona Coyotes,ARI,1,VEG,2,3,5,22,28,15,3,6,9,34,28,20
2023-24,2/8/2024,202402080BOS,Boston Bruins,BOS,1,VAN,4,6,10,24,28,16,0,0,0,17,31,7
2023-24,2/8/2024,202402080CAR,Carolina Hurricanes,CAR,1,COL,5,10,15,28,19,10,2,3,5,27,14,18
2023-24,2/8/2024,202402080FLA,Florida Panthers,FLA,1,WSH,4,5,9,41,23,20,2,4,6,23,22,27
2023-24,2/8/2024,202402080NJD,Calgary Flames,CGY,0,NJD,5,8,13,30,10,14,3,5,8,40,14,17
2023-24,2/8/2024,202402080NYI,New York Islanders,NYI,1,TBL,6,7,13,24,33,21,2,3,5,20,29,13
2023-24,2/8/2024,202402080PHI,Philadelphia Flyers,PHI,1,WPG,4,6,10,21,21,22,1,2,3,29,23,19
2023-24,2/8/2024,202402080ARI,Vegas Golden Knights,VEG,0,ARI,3,6,9,34,28,20,2,3,5,22,28,15
2023-24,2/8/2024,202402080BOS,Vancouver Canucks,VAN,0,BOS,0,0,0,17,31,7,4,6,10,24,28,16
2023-24,2/8/2024,202402080CAR,Colorado Avalanche,COL,0,CAR,2,3,5,27,14,18,5,10,15,28,19,10
2023-24,2/8/2024,202402080FLA,Washington Capitals,WSH,0,FLA,2,4,6,23,22,27,4,5,9,41,23,20
2023-24,2/8/2024,202402080NJD,New Jersey Devils,NJD,1,CGY,3,5,8,40,14,17,5,8,13,30,10,14
2023-24,2/8/2024,202402080NYI,Tampa Bay Lightning,TBL,0,NYI,2,3,5,20,29,13,6,7,13,24,33,21
2023-24,2/8/2024,202402080PHI,Winnipeg Jets,WPG,0,PHI,1,2,3,29,23,19,4,6,10,21,21,22
2023-24,2/7/2024,202402070CHI,Chicago Blackhawks,CHI,1,MIN,1,2,3,21,20,14,2,4,6,25,18,16
2023-24,2/7/2024,202402070NYR,New York Rangers,NYR,1,TBL,3,6,9,24,21,22,1,2,3,18,18,9
2023-24,2/7/2024,202402070TOR,Dallas Stars,DAL,0,TOR,4,6,10,31,34,10,5,7,12,31,41,22
2023-24,2/7/2024,202402070CHI,Minnesota Wild,MIN,0,CHI,2,4,6,25,18,16,1,2,3,21,20,14
2023-24,2/7/2024,202402070NYR,Tampa Bay Lightning,TBL,0,NYR,1,2,3,18,18,9,3,6,9,24,21,22
2023-24,2/7/2024,202402070TOR,Toronto Maple Leafs,TOR,1,DAL,5,7,12,31,41,22,4,6,10,31,34,10
2023-24,2/6/2024,202402060BOS,Boston Bruins,BOS,1,CGY,1,2,3,22,31,18,4,5,9,29,32,17
2023-24,2/6/2024,202402060BUF,Buffalo Sabres,BUF,1,DAL,1,2,3,48,13,13,2,4,6,30,17,23
2023-24,2/6/2024,202402060CAR,Carolina Hurricanes,CAR,1,VAN,2,3,5,24,19,9,3,6,9,19,27,20
2023-24,2/6/2024,202402060FLA,Florida Panthers,FLA,1,PHI,1,0,1,21,31,10,2,2,4,25,31,22
2023-24,2/6/2024,202402060NJD,Colorado Avalanche,COL,0,NJD,3,4,7,38,10,20,5,8,13,31,12,17
2023-24,2/6/2024,202402060PIT,Pittsburgh Penguins,PIT,1,WPG,3,4,7,27,17,17,0,0,0,23,21,13
2023-24,2/6/2024,202402060VEG,Edmonton Oilers,EDM,0,VEG,1,2,3,31,19,17,3,5,8,26,20,26
2023-24,2/6/2024,202402060WSH,Montreal Canadiens,MTL,0,WSH,5,7,12,26,15,20,2,4,6,39,21,6
2023-24,2/6/2024,202402060BOS,Calgary Flames,CGY,0,BOS,4,5,9,29,32,17,1,2,3,22,31,18
2023-24,2/6/2024,202402060BUF,Dallas Stars,DAL,0,BUF,2,4,6,30,17,23,1,2,3,48,13,13
2023-24,2/6/2024,202402060CAR,Vancouver Canucks,VAN,0,CAR,3,6,9,19,27,20,2,3,5,24,19,9
2023-24,2/6/2024,202402060FLA,Philadelphia Flyers,PHI,0,FLA,2,2,4,25,31,22,1,0,1,21,31,10
2023-24,2/6/2024,202402060NJD,New Jersey Devils,NJD,1,COL,5,8,13,31,12,17,3,4,7,38,10,20
2023-24,2/6/2024,202402060PIT,Winnipeg Jets,WPG,0,PIT,0,0,0,23,21,13,3,4,7,27,17,17
2023-24,2/6/2024,202402060VEG,Vegas Golden Knights,VEG,1,EDM,3,5,8,26,20,26,1,2,3,31,19,17
2023-24,2/6/2024,202402060WSH,Washington Capitals,WSH,1,MTL,2,4,6,39,21,6,5,7,12,26,15,20
2023-24,2/5/2024,202402050NYR,Colorado Avalanche,COL,0,NYR,1,2,3,33,21,10,2,3,5,29,18,10
2023-24,2/5/2024,202402050TOR,New York Islanders,NYI,0,TOR,3,5,8,29,42,19,2,4,6,36,28,18
2023-24,2/5/2024,202402050NYR,New York Rangers,NYR,1,COL,2,3,5,29,18,10,1,2,3,33,21,10
2023-24,2/5/2024,202402050TOR,Toronto Maple Leafs,TOR,1,NYI,2,4,6,36,28,18,3,5,8,29,42,19
2023-24,1/31/2024,202401310ANA,Anaheim Ducks,ANA,1,SJS,3,6,9,34,25,14,2,4,6,28,27,27
2023-24,1/31/2024,202401310DET,Detroit Red Wings,DET,1,OTT,2,3,5,25,22,16,3,5,8,25,18,15
2023-24,1/31/2024,202401310NSH,Los Angeles Kings,LAK,0,NSH,4,6,10,24,28,12,2,4,6,42,23,14
2023-24,1/31/2024,202401310ANA,San Jose Sharks,SJS,0,ANA,2,4,6,28,27,27,3,6,9,34,25,14
2023-24,1/31/2024,202401310DET,Ottawa Senators,OTT,0,DET,3,5,8,25,18,15,2,3,5,25,22,16
2023-24,1/31/2024,202401310NSH,Nashville Predators,NSH,1,LAK,2,4,6,42,23,14,4,6,10,24,28,12
2023-24,1/30/2024,202401300SJS,Seattle Kraken,SEA,0,SJS,0,0,0,32,13,14,2,3,5,22,21,17
2023-24,1/30/2024,202401300STL,Columbus Blue Jackets,CBJ,0,STL,1,2,3,22,18,17,0,0,0,21,19,16
2023-24,1/30/2024,202401300SJS,San Jose Sharks,SJS,1,SEA,2,3,5,22,21,17,0,0,0,32,13,14
2023-24,1/30/2024,202401300STL,St. Louis Blues,STL,1,CBJ,0,0,0,21,19,16,1,2,3,22,18,17
2023-24,1/29/2024,202401290OTT,Nashville Predators,NSH,0,OTT,3,6,9,28,23,15,4,4,8,35,23,25
2023-24,1/29/2024,202401290OTT,Ottawa Senators,OTT,1,NSH,4,4,8,35,23,25,3,6,9,28,23,15
2023-24,1/28/2024,202401280SEA,Columbus Blue Jackets,CBJ,0,SEA,2,2,4,32,20,20,4,6,10,26,16,10
2023-24,1/28/2024,202401280STL,Los Angeles Kings,LAK,0,STL,3,6,9,33,20,13,4,7,11,32,26,9
2023-24,1/28/2024,202401280SEA,Seattle Kraken,SEA,1,CBJ,4,6,10,26,16,10,2,2,4,32,20,20
2023-24,1/28/2024,202401280STL,St. Louis Blues,STL,1,LAK,4,7,11,32,26,9,3,6,9,33,20,13
2023-24,1/27/2024,202401270CAR,Arizona Coyotes,ARI,0,CAR,1,2,3,11,19,24,3,5,8,39,24,14
2023-24,1/27/2024,202401270CGY,Calgary Flames,CGY,1,CHI,1,2,3,31,25,11,0,0,0,32,23,19
2023-24,1/27/2024,202401270DAL,Dallas Stars,DAL,1,WSH,5,10,15,35,15,14,4,8,12,28,25,20
2023-24,1/27/2024,202401270DET,Detroit Red Wings,DET,1,VEG,5,9,14,29,19,10,2,4,6,30,14,12
2023-24,1/27/2024,202401270EDM,Edmonton Oilers,EDM,1,NSH,4,8,12,21,30,17,1,2,3,29,31,13
2023-24,1/27/2024,202401270MIN,Anaheim Ducks,ANA,0,MIN,3,6,9,25,18,18,2,4,6,37,12,12
2023-24,1/27/2024,202401270NYI,Florida Panthers,FLA,0,NYI,3,5,8,37,20,8,2,4,6,23,21,24
2023-24,1/27/2024,202401270OTT,New York Rangers,NYR,0,OTT,7,12,19,29,29,14,2,3,5,31,26,17
2023-24,1/27/2024,202401270PHI,Boston Bruins,BOS,0,PHI,6,9,15,28,19,20,2,3,5,37,21,10
2023-24,1/27/2024,202401270PIT,Montreal Canadiens,MTL,0,PIT,2,4,6,27,23,26,3,6,9,33,23,4
2023-24,1/27/2024,202401270SJS,Buffalo Sabres,BUF,0,SJS,5,7,12,36,14,17,2,3,5,26,14,12
2023-24,1/27/2024,202401270TBL,New Jersey Devils,NJD,0,TBL,3,5,8,24,41,16,6,10,16,42,38,8
2023-24,1/27/2024,202401270VAN,Columbus Blue Jackets,CBJ,0,VAN,4,6,10,29,25,13,5,10,15,34,27,14
2023-24,1/27/2024,202401270WPG,Toronto Maple Leafs,TOR,0,WPG,4,5,9,30,18,12,2,2,4,26,13,9
2023-24,1/27/2024,202401270CAR,Carolina Hurricanes,CAR,1,ARI,3,5,8,39,24,14,1,2,3,11,19,24
2023-24,1/27/2024,202401270CGY,Chicago Blackhawks,CHI,0,CGY,0,0,0,32,23,19,1,2,3,31,25,11
2023-24,1/27/2024,202401270DAL,Washington Capitals,WSH,0,DAL,4,8,12,28,25,20,5,10,15,35,15,14
2023-24,1/27/2024,202401270DET,Vegas Golden Knights,VEG,0,DET,2,4,6,30,14,12,5,9,14,29,19,10
2023-24,1/27/2024,202401270EDM,Nashville Predators,NSH,0,EDM,1,2,3,29,31,13,4,8,12,21,30,17
2023-24,1/27/2024,202401270MIN,Minnesota Wild,MIN,1,ANA,2,4,6,37,12,12,3,6,9,25,18,18
2023-24,1/27/2024,202401270NYI,New York Islanders,NYI,1,FLA,2,4,6,23,21,24,3,5,8,37,20,8
2023-24,1/27/2024,202401270OTT,Ottawa Senators,OTT,1,NYR,2,3,5,31,26,17,7,12,19,29,29,14
2023-24,1/27/2024,202401270PHI,Philadelphia Flyers,PHI,1,BOS,2,3,5,37,21,10,6,9,15,28,19,20
2023-24,1/27/2024,202401270PIT,Pittsburgh Penguins,PIT,1,MTL,3,6,9,33,23,4,2,4,6,27,23,26
2023-24,1/27/2024,202401270SJS,San Jose Sharks,SJS,1,BUF,2,3,5,26,14,12,5,7,12,36,14,17
2023-24,1/27/2024,202401270TBL,Tampa Bay Lightning,TBL,1,NJD,6,10,16,42,38,8,3,5,8,24,41,16
2023-24,1/27/2024,202401270VAN,Vancouver Canucks,VAN,1,CBJ,5,10,15,34,27,14,4,6,10,29,25,13
2023-24,1/27/2024,202401270WPG,Winnipeg Jets,WPG,1,TOR,2,2,4,26,13,9,4,5,9,30,18,12
2023-24,1/26/2024,202401260COL,Colorado Avalanche,COL,1,LAK,5,8,13,31,18,15,1,2,3,27,13,14
2023-24,1/26/2024,202401260NYR,New York Rangers,NYR,1,VEG,2,4,6,38,29,10,5,8,13,20,13,24
2023-24,1/26/2024,202401260PIT,Florida Panthers,FLA,0,PIT,2,4,6,31,28,22,2,4,6,37,27,20
2023-24,1/26/2024,202401260SEA,Seattle Kraken,SEA,1,STL,3,6,9,36,14,7,4,6,10,18,15,19
2023-24,1/26/2024,202401260COL,Los Angeles Kings,LAK,0,COL,1,2,3,27,13,14,5,8,13,31,18,15
2023-24,1/26/2024,202401260NYR,Vegas Golden Knights,VEG,0,NYR,5,8,13,20,13,24,2,4,6,38,29,10
2023-24,1/26/2024,202401260PIT,Pittsburgh Penguins,PIT,1,FLA,2,4,6,37,27,20,2,4,6,31,28,22
2023-24,1/26/2024,202401260SEA,St. Louis Blues,STL,0,SEA,4,6,10,18,15,19,3,6,9,36,14,7
2023-24,1/25/2024,202401250CAR,Carolina Hurricanes,CAR,1,NJD,3,5,8,23,20,14,2,3,5,25,19,7
2023-24,1/25/2024,202401250CGY,Columbus Blue Jackets,CBJ,0,CGY,5,7,12,32,18,10,2,4,6,30,15,19
2023-24,1/25/2024,202401250DAL,Anaheim Ducks,ANA,0,DAL,3,5,8,21,24,17,4,5,9,44,9,6
2023-24,1/25/2024,202401250DET,Detroit Red Wings,DET,1,PHI,3,4,7,17,12,22,0,0,0,30,15,18
2023-24,1/25/2024,202401250EDM,Chicago Blackhawks,CHI,0,EDM,0,0,0,27,31,13,3,5,8,34,20,9
2023-24,1/25/2024,202401250MIN,Minnesota Wild,MIN,1,NSH,2,4,6,24,19,20,3,5,8,29,34,15
2023-24,1/25/2024,202401250MTL,Montreal Canadiens,MTL,1,NYI,4,6,10,26,23,18,3,6,9,46,15,10
2023-24,1/25/2024,202401250OTT,Boston Bruins,BOS,0,OTT,3,5,8,23,24,19,2,4,6,37,32,12
2023-24,1/25/2024,202401250TBL,Arizona Coyotes,ARI,0,TBL,3,5,8,20,38,16,6,10,16,37,25,15
2023-24,1/25/2024,202401250CAR,New Jersey Devils,NJD,0,CAR,2,3,5,25,19,7,3,5,8,23,20,14
2023-24,1/25/2024,202401250CGY,Calgary Flames,CGY,1,CBJ,2,4,6,30,15,19,5,7,12,32,18,10
2023-24,1/25/2024,202401250DAL,Dallas Stars,DAL,1,ANA,4,5,9,44,9,6,3,5,8,21,24,17
2023-24,1/25/2024,202401250DET,Philadelphia Flyers,PHI,0,DET,0,0,0,30,15,18,3,4,7,17,12,22
2023-24,1/25/2024,202401250EDM,Edmonton Oilers,EDM,1,CHI,3,5,8,34,20,9,0,0,0,27,31,13
2023-24,1/25/2024,202401250MIN,Nashville Predators,NSH,0,MIN,3,5,8,29,34,15,2,4,6,24,19,20
2023-24,1/25/2024,202401250MTL,New York Islanders,NYI,0,MTL,3,6,9,46,15,10,4,6,10,26,23,18
2023-24,1/25/2024,202401250OTT,Ottawa Senators,OTT,1,BOS,2,4,6,37,32,12,3,5,8,23,24,19
2023-24,1/25/2024,202401250TBL,Tampa Bay Lightning,TBL,1,ARI,6,10,16,37,25,15,3,5,8,20,38,16
2023-24,1/24/2024,202401240BOS,Boston Bruins,BOS,1,CAR,2,4,6,28,31,13,3,6,9,33,32,7
2023-24,1/24/2024,202401240COL,Colorado Avalanche,COL,1,WSH,6,10,16,31,16,24,2,4,6,25,19,15
2023-24,1/24/2024,202401240FLA,Arizona Coyotes,ARI,0,FLA,2,4,6,33,18,9,6,11,17,42,20,11
2023-24,1/24/2024,202401240LAK,Buffalo Sabres,BUF,0,LAK,5,8,13,37,16,13,3,6,9,40,26,23
2023-24,1/24/2024,202401240SEA,Chicago Blackhawks,CHI,0,SEA,2,4,6,34,16,19,6,10,16,29,7,17
2023-24,1/24/2024,202401240TOR,Toronto Maple Leafs,TOR,1,WPG,1,2,3,30,23,19,0,0,0,32,25,10
2023-24,1/24/2024,202401240VAN,St. Louis Blues,STL,0,VAN,4,6,10,18,26,23,3,5,8,32,20,15
2023-24,1/24/2024,202401240BOS,Carolina Hurricanes,CAR,0,BOS,3,6,9,33,32,7,2,4,6,28,31,13
2023-24,1/24/2024,202401240COL,Washington Capitals,WSH,0,COL,2,4,6,25,19,15,6,10,16,31,16,24
2023-24,1/24/2024,202401240FLA,Florida Panthers,FLA,1,ARI,6,11,17,42,20,11,2,4,6,33,18,9
2023-24,1/24/2024,202401240LAK,Los Angeles Kings,LAK,1,BUF,3,6,9,40,26,23,5,8,13,37,16,13
2023-24,1/24/2024,202401240SEA,Seattle Kraken,SEA,1,CHI,6,10,16,29,7,17,2,4,6,34,16,19
2023-24,1/24/2024,202401240TOR,Winnipeg Jets,WPG,0,TOR,0,0,0,32,25,10,1,2,3,30,23,19
2023-24,1/24/2024,202401240VAN,Vancouver Canucks,VAN,1,STL,3,5,8,32,20,15,4,6,10,18,26,23
2023-24,1/23/2024,202401230ANA,Anaheim Ducks,ANA,1,BUF,4,7,11,36,26,16,2,4,6,30,27,10
2023-24,1/23/2024,202401230CGY,Calgary Flames,CGY,1,STL,3,6,9,35,19,13,4,6,10,26,27,17
2023-24,1/23/2024,202401230DET,Dallas Stars,DAL,0,DET,5,9,14,38,10,25,4,6,10,34,23,18
2023-24,1/23/2024,202401230EDM,Columbus Blue Jackets,CBJ,0,EDM,1,1,2,27,25,15,4,8,12,24,28,16
2023-24,1/23/2024,202401230MIN,Minnesota Wild,MIN,1,WSH,5,9,14,30,16,11,3,6,9,33,16,13
2023-24,1/23/2024,202401230MTL,Montreal Canadiens,MTL,1,OTT,1,2,3,25,34,13,4,5,9,28,18,15
2023-24,1/23/2024,202401230NYI,New York Islanders,NYI,1,VEG,2,4,6,42,31,7,3,5,8,27,14,14
2023-24,1/23/2024,202401230PHI,Philadelphia Flyers,PHI,1,TBL,3,5,8,32,17,23,6,11,17,21,13,17
2023-24,1/23/2024,202401230SJS,New York Rangers,NYR,0,SJS,2,4,6,31,20,15,3,4,7,22,12,16
2023-24,1/23/2024,202401230ANA,Buffalo Sabres,BUF,0,ANA,2,4,6,30,27,10,4,7,11,36,26,16
2023-24,1/23/2024,202401230CGY,St. Louis Blues,STL,0,CGY,4,6,10,26,27,17,3,6,9,35,19,13
2023-24,1/23/2024,202401230DET,Detroit Red Wings,DET,1,DAL,4,6,10,34,23,18,5,9,14,38,10,25
2023-24,1/23/2024,202401230EDM,Edmonton Oilers,EDM,1,CBJ,4,8,12,24,28,16,1,1,2,27,25,15
2023-24,1/23/2024,202401230MIN,Washington Capitals,WSH,0,MIN,3,6,9,33,16,13,5,9,14,30,16,11
2023-24,1/23/2024,202401230MTL,Ottawa Senators,OTT,0,MTL,4,5,9,28,18,15,1,2,3,25,34,13
2023-24,1/23/2024,202401230NYI,Vegas Golden Knights,VEG,0,NYI,3,5,8,27,14,14,2,4,6,42,31,7
2023-24,1/23/2024,202401230PHI,Tampa Bay Lightning,TBL,0,PHI,6,11,17,21,13,17,3,5,8,32,17,23
2023-24,1/23/2024,202401230SJS,San Jose Sharks,SJS,1,NYR,3,4,7,22,12,16,2,4,6,31,20,15
2023-24,1/22/2024,202401220ARI,Arizona Coyotes,ARI,1,PIT,5,7,12,27,20,11,2,3,5,27,23,18
2023-24,1/22/2024,202401220BOS,Boston Bruins,BOS,1,WPG,4,6,10,20,34,17,1,2,3,21,43,11
2023-24,1/22/2024,202401220LAK,Los Angeles Kings,LAK,1,SJS,3,5,8,47,20,21,3,5,8,27,26,20
2023-24,1/22/2024,202401220NJD,New Jersey Devils,NJD,1,VEG,6,10,16,38,16,11,5,9,14,32,16,17
2023-24,1/22/2024,202401220NSH,Florida Panthers,FLA,0,NSH,4,5,9,38,35,18,1,1,2,27,31,18
2023-24,1/22/2024,202401220VAN,Chicago Blackhawks,CHI,0,VAN,0,0,0,31,26,9,2,4,6,29,28,9
2023-24,1/22/2024,202401220ARI,Pittsburgh Penguins,PIT,0,ARI,2,3,5,27,23,18,5,7,12,27,20,11
2023-24,1/22/2024,202401220BOS,Winnipeg Jets,WPG,0,BOS,1,2,3,21,43,11,4,6,10,20,34,17
2023-24,1/22/2024,202401220LAK,San Jose Sharks,SJS,0,LAK,3,5,8,27,26,20,3,5,8,47,20,21
2023-24,1/22/2024,202401220NJD,Vegas Golden Knights,VEG,0,NJD,5,9,14,32,16,17,6,10,16,38,16,11
2023-24,1/22/2024,202401220NSH,Nashville Predators,NSH,1,FLA,1,1,2,27,31,18,4,5,9,38,35,18
2023-24,1/22/2024,202401220VAN,Vancouver Canucks,VAN,1,CHI,2,4,6,29,28,9,0,0,0,31,26,9
2023-24,1/21/2024,202401210ANA,Anaheim Ducks,ANA,1,NYR,2,4,6,18,23,24,5,7,12,33,21,13
2023-24,1/21/2024,202401210CAR,Carolina Hurricanes,CAR,1,MIN,2,4,6,42,15,10,5,9,14,19,21,22
2023-24,1/21/2024,202401210DET,Detroit Red Wings,DET,1,TBL,2,3,5,35,18,9,1,2,3,28,12,16
2023-24,1/21/2024,202401210NYI,Dallas Stars,DAL,0,NYI,2,4,6,43,16,11,3,5,8,28,38,23
2023-24,1/21/2024,202401210PHI,Ottawa Senators,OTT,0,PHI,5,6,11,34,21,18,3,6,9,25,27,12
2023-24,1/21/2024,202401210SEA,Seattle Kraken,SEA,1,TOR,1,2,3,17,24,16,3,3,6,26,17,18
2023-24,1/21/2024,202401210ANA,New York Rangers,NYR,0,ANA,5,7,12,33,21,13,2,4,6,18,23,24
2023-24,1/21/2024,202401210CAR,Minnesota Wild,MIN,0,CAR,5,9,14,19,21,22,2,4,6,42,15,10
2023-24,1/21/2024,202401210DET,Tampa Bay Lightning,TBL,0,DET,1,2,3,28,12,16,2,3,5,35,18,9
2023-24,1/21/2024,202401210NYI,New York Islanders,NYI,1,DAL,3,5,8,28,38,23,2,4,6,43,16,11
2023-24,1/21/2024,202401210PHI,Philadelphia Flyers,PHI,1,OTT,3,6,9,25,27,12,5,6,11,34,21,18
2023-24,1/21/2024,202401210SEA,Toronto Maple Leafs,TOR,0,SEA,3,3,6,26,17,18,1,2,3,17,24,16
2023-24,1/20/2024,202401200ARI,Arizona Coyotes,ARI,1,NSH,3,5,8,24,29,18,2,4,6,32,26,12
2023-24,1/20/2024,202401200BOS,Boston Bruins,BOS,1,MTL,9,14,23,36,39,14,4,7,11,21,44,7
2023-24,1/20/2024,202401200BUF,Buffalo Sabres,BUF,1,TBL,1,2,3,27,18,11,3,4,7,16,16,13
2023-24,1/20/2024,202401200CGY,Calgary Flames,CGY,1,EDM,1,1,2,27,32,8,3,5,8,32,25,13
2023-24,1/20/2024,202401200LAK,Los Angeles Kings,LAK,1,NYR,2,1,3,26,21,13,1,2,3,23,32,20
2023-24,1/20/2024,202401200NJD,Dallas Stars,DAL,0,NJD,6,11,17,36,12,17,2,2,4,31,25,18
2023-24,1/20/2024,202401200OTT,Ottawa Senators,OTT,1,WPG,1,2,3,35,25,14,2,4,6,29,22,13
2023-24,1/20/2024,202401200PHI,Colorado Avalanche,COL,0,PHI,7,14,21,25,25,28,4,8,12,40,19,12
2023-24,1/20/2024,202401200SJS,Anaheim Ducks,ANA,0,SJS,3,4,7,34,13,21,5,6,11,19,18,18
2023-24,1/20/2024,202401200STL,St. Louis Blues,STL,1,WSH,3,5,8,29,21,13,0,0,0,18,15,15
2023-24,1/20/2024,202401200VAN,Toronto Maple Leafs,TOR,0,VAN,4,5,9,46,40,14,6,11,17,21,52,19
2023-24,1/20/2024,202401200VEG,Pittsburgh Penguins,PIT,0,VEG,2,4,6,25,22,14,3,6,9,29,18,18
2023-24,1/20/2024,202401200ARI,Nashville Predators,NSH,0,ARI,2,4,6,32,26,12,3,5,8,24,29,18
2023-24,1/20/2024,202401200BOS,Montreal Canadiens,MTL,0,BOS,4,7,11,21,44,7,9,14,23,36,39,14
2023-24,1/20/2024,202401200BUF,Tampa Bay Lightning,TBL,0,BUF,3,4,7,16,16,13,1,2,3,27,18,11
2023-24,1/20/2024,202401200CGY,Edmonton Oilers,EDM,0,CGY,3,5,8,32,25,13,1,1,2,27,32,8
2023-24,1/20/2024,202401200LAK,New York Rangers,NYR,0,LAK,1,2,3,23,32,20,2,1,3,26,21,13
2023-24,1/20/2024,202401200NJD,New Jersey Devils,NJD,1,DAL,2,2,4,31,25,18,6,11,17,36,12,17
2023-24,1/20/2024,202401200OTT,Winnipeg Jets,WPG,0,OTT,2,4,6,29,22,13,1,2,3,35,25,14
2023-24,1/20/2024,202401200PHI,Philadelphia Flyers,PHI,1,COL,4,8,12,40,19,12,7,14,21,25,25,28
2023-24,1/20/2024,202401200SJS,San Jose Sharks,SJS,1,ANA,5,6,11,19,18,18,3,4,7,34,13,21
2023-24,1/20/2024,202401200STL,Washington Capitals,WSH,0,STL,0,0,0,18,15,15,3,5,8,29,21,13
2023-24,1/20/2024,202401200VAN,Vancouver Canucks,VAN,1,TOR,6,11,17,21,52,19,4,5,9,46,40,14
2023-24,1/20/2024,202401200VEG,Vegas Golden Knights,VEG,1,PIT,3,6,9,29,18,18,2,4,6,25,22,14
2023-24,1/19/2024,202401190CAR,Carolina Hurricanes,CAR,1,DET,4,8,12,30,11,10,2,4,6,12,13,17
2023-24,1/19/2024,202401190CBJ,Columbus Blue Jackets,CBJ,1,NJD,1,2,3,30,24,19,4,4,8,33,11,19
2023-24,1/19/2024,202401190CHI,Chicago Blackhawks,CHI,1,NYI,4,8,12,24,24,24,3,6,9,30,31,18
2023-24,1/19/2024,202401190FLA,Florida Panthers,FLA,1,MIN,4,7,11,35,28,8,6,10,16,26,20,26
2023-24,1/19/2024,202401190CAR,Detroit Red Wings,DET,0,CAR,2,4,6,12,13,17,4,8,12,30,11,10
2023-24,1/19/2024,202401190CBJ,New Jersey Devils,NJD,0,CBJ,4,4,8,33,11,19,1,2,3,30,24,19
2023-24,1/19/2024,202401190CHI,New York Islanders,NYI,0,CHI,3,6,9,30,31,18,4,8,12,24,24,24
2023-24,1/19/2024,202401190FLA,Minnesota Wild,MIN,0,FLA,6,10,16,26,20,26,4,7,11,35,28,8
2023-24,1/18/2024,202401180BOS,Boston Bruins,BOS,1,COL,5,7,12,31,27,14,2,4,6,32,32,17
2023-24,1/18/2024,202401180BUF,Buffalo Sabres,BUF,1,CHI,3,6,9,31,14,13,0,0,0,19,25,19
2023-24,1/18/2024,202401180CGY,Calgary Flames,CGY,1,TOR,3,6,9,26,19,13,4,8,12,32,27,13
2023-24,1/18/2024,202401180EDM,Edmonton Oilers,EDM,1,SEA,4,8,12,36,16,18,2,3,5,27,38,9
2023-24,1/18/2024,202401180LAK,Los Angeles Kings,LAK,1,NSH,1,2,3,34,22,16,2,4,6,33,29,23
2023-24,1/18/2024,202401180OTT,Montreal Canadiens,MTL,0,OTT,2,1,3,23,18,12,6,10,16,37,23,15
2023-24,1/18/2024,202401180PHI,Dallas Stars,DAL,0,PHI,1,1,2,15,23,20,5,5,10,43,20,20
2023-24,1/18/2024,202401180TBL,Minnesota Wild,MIN,0,TBL,3,6,9,33,23,13,7,13,20,38,26,17
2023-24,1/18/2024,202401180VAN,Arizona Coyotes,ARI,0,VAN,1,2,3,21,25,11,2,4,6,26,25,10
2023-24,1/18/2024,202401180VEG,New York Rangers,NYR,0,VEG,1,2,3,30,25,16,5,9,14,26,24,20
2023-24,1/18/2024,202401180WSH,St. Louis Blues,STL,0,WSH,2,4,6,20,8,15,5,8,13,26,11,16
2023-24,1/18/2024,202401180BOS,Colorado Avalanche,COL,0,BOS,2,4,6,32,32,17,5,7,12,31,27,14
2023-24,1/18/2024,202401180BUF,Chicago Blackhawks,CHI,0,BUF,0,0,0,19,25,19,3,6,9,31,14,13
2023-24,1/18/2024,202401180CGY,Toronto Maple Leafs,TOR,0,CGY,4,8,12,32,27,13,3,6,9,26,19,13
2023-24,1/18/2024,202401180EDM,Seattle Kraken,SEA,0,EDM,2,3,5,27,38,9,4,8,12,36,16,18
2023-24,1/18/2024,202401180LAK,Nashville Predators,NSH,0,LAK,2,4,6,33,29,23,1,2,3,34,22,16
2023-24,1/18/2024,202401180OTT,Ottawa Senators,OTT,1,MTL,6,10,16,37,23,15,2,1,3,23,18,12
2023-24,1/18/2024,202401180PHI,Philadelphia Flyers,PHI,1,DAL,5,5,10,43,20,20,1,1,2,15,23,20
2023-24,1/18/2024,202401180TBL,Tampa Bay Lightning,TBL,1,MIN,7,13,20,38,26,17,3,6,9,33,23,13
2023-24,1/18/2024,202401180VAN,Vancouver Canucks,VAN,1,ARI,2,4,6,26,25,10,1,2,3,21,25,11
2023-24,1/18/2024,202401180VEG,Vegas Golden Knights,VEG,1,NYR,5,9,14,26,24,20,1,2,3,30,25,16
2023-24,1/18/2024,202401180WSH,Washington Capitals,WSH,1,STL,5,8,13,26,11,16,2,4,6,20,8,15
2023-24,1/17/2024,202401170FLA,Detroit Red Wings,DET,0,FLA,3,6,9,29,27,26,2,3,5,34,19,13
2023-24,1/17/2024,202401170NJD,Montreal Canadiens,MTL,0,NJD,3,5,8,25,12,17,2,4,6,30,17,12
2023-24,1/17/2024,202401170FLA,Florida Panthers,FLA,1,DET,2,3,5,34,19,13,3,6,9,29,27,26
2023-24,1/17/2024,202401170NJD,New Jersey Devils,NJD,1,MTL,2,4,6,30,17,12,3,5,8,25,12,17
2023-24,1/16/2024,202401160CGY,Arizona Coyotes,ARI,0,CGY,2,4,6,25,17,12,3,4,7,30,12,17
2023-24,1/16/2024,202401160CHI,Chicago Blackhawks,CHI,1,SJS,1,2,3,25,26,8,1,2,3,38,35,21
2023-24,1/16/2024,202401160DAL,Dallas Stars,DAL,1,LAK,5,9,14,28,23,22,1,2,3,32,18,15
2023-24,1/16/2024,202401160EDM,Edmonton Oilers,EDM,1,TOR,4,6,10,32,32,9,2,4,6,27,27,22
2023-24,1/16/2024,202401160NYR,New York Rangers,NYR,1,SEA,5,8,13,23,24,15,2,4,6,31,18,12
2023-24,1/16/2024,202401160OTT,Colorado Avalanche,COL,0,OTT,7,12,19,34,25,23,4,8,12,40,17,15
2023-24,1/16/2024,202401160WPG,New York Islanders,NYI,0,WPG,2,3,5,37,31,11,4,6,10,44,17,12
2023-24,1/16/2024,202401160WSH,Anaheim Ducks,ANA,0,WSH,0,0,0,24,23,11,2,4,6,28,21,21
2023-24,1/16/2024,202401160CGY,Calgary Flames,CGY,1,ARI,3,4,7,30,12,17,2,4,6,25,17,12
2023-24,1/16/2024,202401160CHI,San Jose Sharks,SJS,0,CHI,1,2,3,38,35,21,1,2,3,25,26,8
2023-24,1/16/2024,202401160DAL,Los Angeles Kings,LAK,0,DAL,1,2,3,32,18,15,5,9,14,28,23,22
2023-24,1/16/2024,202401160EDM,Toronto Maple Leafs,TOR,0,EDM,2,4,6,27,27,22,4,6,10,32,32,9
2023-24,1/16/2024,202401160NYR,Seattle Kraken,SEA,0,NYR,2,4,6,31,18,12,5,8,13,23,24,15
2023-24,1/16/2024,202401160OTT,Ottawa Senators,OTT,1,COL,4,8,12,40,17,15,7,12,19,34,25,23
2023-24,1/16/2024,202401160WPG,Winnipeg Jets,WPG,1,NYI,4,6,10,44,17,12,2,3,5,37,31,11
2023-24,1/16/2024,202401160WSH,Washington Capitals,WSH,1,ANA,2,4,6,28,21,21,0,0,0,24,23,11
2023-24,1/15/2024,202401150BOS,Boston Bruins,BOS,1,NJD,3,4,7,36,32,15,0,0,0,31,29,13
2023-24,1/15/2024,202401150BUF,Buffalo Sabres,BUF,1,SJS,3,6,9,35,18,17,0,0,0,28,33,14
2023-24,1/15/2024,202401150CAR,Carolina Hurricanes,CAR,1,LAK,2,4,6,32,15,9,5,10,15,26,17,18
2023-24,1/15/2024,202401150CBJ,Columbus Blue Jackets,CBJ,1,VAN,3,4,7,43,19,15,3,5,8,30,19,11
2023-24,1/15/2024,202401150FLA,Anaheim Ducks,ANA,0,FLA,5,6,11,26,22,19,4,7,11,33,17,11
2023-24,1/15/2024,202401150MIN,Minnesota Wild,MIN,1,NYI,5,8,13,40,14,14,0,0,0,21,28,12
2023-24,1/15/2024,202401150MTL,Colorado Avalanche,COL,0,MTL,3,6,9,35,11,8,4,8,12,34,10,25
2023-24,1/15/2024,202401150PIT,Pittsburgh Penguins,PIT,1,SEA,3,6,9,33,14,12,0,0,0,22,22,16
2023-24,1/15/2024,202401150STL,Philadelphia Flyers,PHI,0,STL,4,6,10,42,16,16,2,4,6,30,17,19
2023-24,1/15/2024,202401150VEG,Nashville Predators,NSH,0,VEG,1,2,3,35,48,25,4,7,11,29,26,21
2023-24,1/15/2024,202401150BOS,New Jersey Devils,NJD,0,BOS,0,0,0,31,29,13,3,4,7,36,32,15
2023-24,1/15/2024,202401150BUF,San Jose Sharks,SJS,0,BUF,0,0,0,28,33,14,3,6,9,35,18,17
2023-24,1/15/2024,202401150CAR,Los Angeles Kings,LAK,0,CAR,5,10,15,26,17,18,2,4,6,32,15,9
2023-24,1/15/2024,202401150CBJ,Vancouver Canucks,VAN,0,CBJ,3,5,8,30,19,11,3,4,7,43,19,15
2023-24,1/15/2024,202401150FLA,Florida Panthers,FLA,1,ANA,4,7,11,33,17,11,5,6,11,26,22,19
2023-24,1/15/2024,202401150MIN,New York Islanders,NYI,0,MIN,0,0,0,21,28,12,5,8,13,40,14,14
2023-24,1/15/2024,202401150MTL,Montreal Canadiens,MTL,1,COL,4,8,12,34,10,25,3,6,9,35,11,8
2023-24,1/15/2024,202401150PIT,Seattle Kraken,SEA,0,PIT,0,0,0,22,22,16,3,6,9,33,14,12
2023-24,1/15/2024,202401150STL,St. Louis Blues,STL,1,PHI,2,4,6,30,17,19,4,6,10,42,16,16
2023-24,1/15/2024,202401150VEG,Vegas Golden Knights,VEG,1,NSH,4,7,11,29,26,21,1,2,3,35,48,25
2023-24,1/14/2024,202401140NYR,New York Rangers,NYR,1,WSH,2,3,5,31,24,23,1,2,3,25,20,11
2023-24,1/14/2024,202401140TOR,Detroit Red Wings,DET,0,TOR,4,5,9,24,43,20,2,3,5,30,28,14
2023-24,1/14/2024,202401140NYR,Washington Capitals,WSH,0,NYR,1,2,3,25,20,11,2,3,5,31,24,23
2023-24,1/14/2024,202401140TOR,Toronto Maple Leafs,TOR,1,DET,2,3,5,30,28,14,4,5,9,24,43,20
2023-24,1/13/2024,202401130BUF,Buffalo Sabres,BUF,1,VAN,0,0,0,26,22,12,1,1,2,23,27,17
2023-24,1/13/2024,202401130CAR,Carolina Hurricanes,CAR,1,PIT,3,5,8,35,19,16,2,4,6,40,19,9
2023-24,1/13/2024,202401130CBJ,Columbus Blue Jackets,CBJ,1,SEA,4,7,11,34,18,7,7,13,20,36,25,26
2023-24,1/13/2024,202401130CHI,Chicago Blackhawks,CHI,1,DAL,1,1,2,35,27,17,3,6,9,30,23,12
2023-24,1/13/2024,202401130DET,Detroit Red Wings,DET,1,LAK,5,9,14,30,25,17,3,6,9,36,16,13
2023-24,1/13/2024,202401130FLA,Florida Panthers,FLA,1,NJD,1,2,3,36,30,10,4,4,8,22,22,21
2023-24,1/13/2024,202401130MIN,Arizona Coyotes,ARI,0,MIN,6,11,17,33,17,18,0,0,0,38,32,9
2023-24,1/13/2024,202401130MTL,Edmonton Oilers,EDM,0,MTL,2,4,6,41,12,10,1,2,3,24,17,24
2023-24,1/13/2024,202401130NSH,Nashville Predators,NSH,1,NYI,3,5,8,28,26,23,1,2,3,25,33,25
2023-24,1/13/2024,202401130OTT,Ottawa Senators,OTT,1,SJS,5,10,15,41,26,15,4,8,12,18,38,26
2023-24,1/13/2024,202401130STL,Boston Bruins,BOS,0,STL,4,6,10,35,18,6,3,6,9,23,17,15
2023-24,1/13/2024,202401130TBL,Anaheim Ducks,ANA,0,TBL,1,2,3,20,37,11,5,8,13,41,21,12
2023-24,1/13/2024,202401130TOR,Colorado Avalanche,COL,0,TOR,5,9,14,33,33,15,3,0,3,29,29,17
2023-24,1/13/2024,202401130VEG,Calgary Flames,CGY,0,VEG,3,5,8,26,20,23,1,2,3,32,41,17
2023-24,1/13/2024,202401130WPG,Philadelphia Flyers,PHI,0,WPG,2,4,6,36,17,22,0,0,0,35,31,11
2023-24,1/13/2024,202401130WSH,New York Rangers,NYR,0,WSH,2,2,4,27,31,14,3,5,8,21,17,22
2023-24,1/13/2024,202401130BUF,Vancouver Canucks,VAN,0,BUF,1,1,2,23,27,17,0,0,0,26,22,12
2023-24,1/13/2024,202401130CAR,Pittsburgh Penguins,PIT,0,CAR,2,4,6,40,19,9,3,5,8,35,19,16
2023-24,1/13/2024,202401130CBJ,Seattle Kraken,SEA,0,CBJ,7,13,20,36,25,26,4,7,11,34,18,7
2023-24,1/13/2024,202401130CHI,Dallas Stars,DAL,0,CHI,3,6,9,30,23,12,1,1,2,35,27,17
2023-24,1/13/2024,202401130DET,Los Angeles Kings,LAK,0,DET,3,6,9,36,16,13,5,9,14,30,25,17
2023-24,1/13/2024,202401130FLA,New Jersey Devils,NJD,0,FLA,4,4,8,22,22,21,1,2,3,36,30,10
2023-24,1/13/2024,202401130MIN,Minnesota Wild,MIN,1,ARI,0,0,0,38,32,9,6,11,17,33,17,18
2023-24,1/13/2024,202401130MTL,Montreal Canadiens,MTL,1,EDM,1,2,3,24,17,24,2,4,6,41,12,10
2023-24,1/13/2024,202401130NSH,New York Islanders,NYI,0,NSH,1,2,3,25,33,25,3,5,8,28,26,23
2023-24,1/13/2024,202401130OTT,San Jose Sharks,SJS,0,OTT,4,8,12,18,38,26,5,10,15,41,26,15
2023-24,1/13/2024,202401130STL,St. Louis Blues,STL,1,BOS,3,6,9,23,17,15,4,6,10,35,18,6
2023-24,1/13/2024,202401130TBL,Tampa Bay Lightning,TBL,1,ANA,5,8,13,41,21,12,1,2,3,20,37,11
2023-24,1/13/2024,202401130TOR,Toronto Maple Leafs,TOR,1,COL,3,0,3,29,29,17,5,9,14,33,33,15
2023-24,1/13/2024,202401130VEG,Vegas Golden Knights,VEG,1,CGY,1,2,3,32,41,17,3,5,8,26,20,23
2023-24,1/13/2024,202401130WPG,Winnipeg Jets,WPG,1,PHI,0,0,0,35,31,11,2,4,6,36,17,22
2023-24,1/13/2024,202401130WSH,Washington Capitals,WSH,1,NYR,3,5,8,21,17,22,2,2,4,27,31,14
2023-24,1/12/2024,202401120DAL,Dallas Stars,DAL,1,NSH,3,6,9,22,24,15,6,7,13,38,35,18
2023-24,1/12/2024,202401120MIN,Minnesota Wild,MIN,1,PHI,3,5,8,29,27,13,4,8,12,35,28,17
2023-24,1/12/2024,202401120DAL,Nashville Predators,NSH,0,DAL,6,7,13,38,35,18,3,6,9,22,24,15
2023-24,1/12/2024,202401120MIN,Philadelphia Flyers,PHI,0,MIN,4,8,12,35,28,17,3,5,8,29,27,13
2023-24,1/11/2024,202401110ARI,Arizona Coyotes,ARI,1,CGY,2,4,6,34,28,10,6,11,17,30,19,27
2023-24,1/11/2024,202401110BUF,Buffalo Sabres,BUF,1,OTT,5,6,11,32,28,27,3,1,4,28,27,14
2023-24,1/11/2024,202401110CAR,Anaheim Ducks,ANA,0,CAR,3,4,7,16,22,15,6,11,17,34,24,10
2023-24,1/11/2024,202401110DET,Detroit Red Wings,DET,1,EDM,2,2,4,18,8,19,3,3,6,47,9,24
2023-24,1/11/2024,202401110FLA,Florida Panthers,FLA,1,LAK,3,5,8,41,27,15,2,4,6,33,21,17
2023-24,1/11/2024,202401110MTL,Montreal Canadiens,MTL,1,SJS,2,4,6,35,22,14,3,4,7,35,39,19
2023-24,1/11/2024,202401110NYI,New York Islanders,NYI,1,TOR,4,7,11,30,31,19,3,5,8,35,18,19
2023-24,1/11/2024,202401110PIT,Pittsburgh Penguins,PIT,1,VAN,3,5,8,35,33,9,4,7,11,29,16,21
2023-24,1/11/2024,202401110STL,New York Rangers,NYR,0,STL,2,4,6,43,20,12,5,9,14,20,17,23
2023-24,1/11/2024,202401110TBL,New Jersey Devils,NJD,0,TBL,3,4,7,30,24,7,4,5,9,20,30,15
2023-24,1/11/2024,202401110VEG,Boston Bruins,BOS,0,VEG,1,1,2,33,26,22,2,4,6,25,28,19
2023-24,1/11/2024,202401110WPG,Chicago Blackhawks,CHI,0,WPG,1,2,3,21,17,27,2,4,6,28,33,20
2023-24,1/11/2024,202401110WSH,Seattle Kraken,SEA,0,WSH,4,7,11,23,11,12,1,2,3,26,11,16
2023-24,1/11/2024,202401110ARI,Calgary Flames,CGY,0,ARI,6,11,17,30,19,27,2,4,6,34,28,10
2023-24,1/11/2024,202401110BUF,Ottawa Senators,OTT,0,BUF,3,1,4,28,27,14,5,6,11,32,28,27
2023-24,1/11/2024,202401110CAR,Carolina Hurricanes,CAR,1,ANA,6,11,17,34,24,10,3,4,7,16,22,15
2023-24,1/11/2024,202401110DET,Edmonton Oilers,EDM,0,DET,3,3,6,47,9,24,2,2,4,18,8,19
2023-24,1/11/2024,202401110FLA,Los Angeles Kings,LAK,0,FLA,2,4,6,33,21,17,3,5,8,41,27,15
2023-24,1/11/2024,202401110MTL,San Jose Sharks,SJS,0,MTL,3,4,7,35,39,19,2,4,6,35,22,14
2023-24,1/11/2024,202401110NYI,Toronto Maple Leafs,TOR,0,NYI,3,5,8,35,18,19,4,7,11,30,31,19
2023-24,1/11/2024,202401110PIT,Vancouver Canucks,VAN,0,PIT,4,7,11,29,16,21,3,5,8,35,33,9
2023-24,1/11/2024,202401110STL,St. Louis Blues,STL,1,NYR,5,9,14,20,17,23,2,4,6,43,20,12
2023-24,1/11/2024,202401110TBL,Tampa Bay Lightning,TBL,1,NJD,4,5,9,20,30,15,3,4,7,30,24,7
2023-24,1/11/2024,202401110VEG,Vegas Golden Knights,VEG,1,BOS,2,4,6,25,28,19,1,1,2,33,26,22
2023-24,1/11/2024,202401110WPG,Winnipeg Jets,WPG,1,CHI,2,4,6,28,33,20,1,2,3,21,17,27
2023-24,1/11/2024,202401110WSH,Washington Capitals,WSH,1,SEA,1,2,3,26,11,16,4,7,11,23,11,12
2023-24,1/10/2024,202401100COL,Colorado Avalanche,COL,1,VEG,3,5,8,35,20,16,0,0,0,25,16,22
2023-24,1/10/2024,202401100DAL,Dallas Stars,DAL,1,MIN,7,9,16,34,13,20,2,4,6,23,34,13
2023-24,1/10/2024,202401100PHI,Montreal Canadiens,MTL,0,PHI,2,4,6,19,24,27,2,4,6,39,22,16
2023-24,1/10/2024,202401100COL,Vegas Golden Knights,VEG,0,COL,0,0,0,25,16,22,3,5,8,35,20,16
2023-24,1/10/2024,202401100DAL,Minnesota Wild,MIN,0,DAL,2,4,6,23,34,13,7,9,16,34,13,20
2023-24,1/10/2024,202401100PHI,Philadelphia Flyers,PHI,1,MTL,2,4,6,39,22,16,2,4,6,19,24,27
2023-24,1/9/2024,202401090ARI,Arizona Coyotes,ARI,1,BOS,4,6,10,36,25,17,3,4,7,33,23,13
2023-24,1/9/2024,202401090BUF,Buffalo Sabres,BUF,1,SEA,2,4,6,38,30,14,5,9,14,26,21,23
2023-24,1/9/2024,202401090CGY,Calgary Flames,CGY,1,OTT,6,9,15,36,24,12,3,6,9,33,13,16
2023-24,1/9/2024,202401090CHI,Chicago Blackhawks,CHI,1,EDM,1,0,1,26,19,15,2,4,6,15,9,16
2023-24,1/9/2024,202401090NSH,Anaheim Ducks,ANA,0,NSH,5,8,13,33,15,17,3,5,8,42,26,12
2023-24,1/9/2024,202401090NYI,New York Islanders,NYI,1,VAN,2,2,4,20,31,17,5,6,11,34,20,10
2023-24,1/9/2024,202401090STL,Florida Panthers,FLA,0,STL,5,8,13,31,29,10,1,2,3,30,14,8
2023-24,1/9/2024,202401090TBL,Los Angeles Kings,LAK,0,TBL,2,4,6,22,41,24,3,4,7,29,29,10
2023-24,1/9/2024,202401090TOR,San Jose Sharks,SJS,0,TOR,1,2,3,23,49,22,7,14,21,46,19,7
2023-24,1/9/2024,202401090WPG,Columbus Blue Jackets,CBJ,0,WPG,0,0,0,29,15,21,5,7,12,23,10,23
2023-24,1/9/2024,202401090ARI,Boston Bruins,BOS,0,ARI,3,4,7,33,23,13,4,6,10,36,25,17
2023-24,1/9/2024,202401090BUF,Seattle Kraken,SEA,0,BUF,5,9,14,26,21,23,2,4,6,38,30,14
2023-24,1/9/2024,202401090CGY,Ottawa Senators,OTT,0,CGY,3,6,9,33,13,16,6,9,15,36,24,12
2023-24,1/9/2024,202401090CHI,Edmonton Oilers,EDM,0,CHI,2,4,6,15,9,16,1,0,1,26,19,15
2023-24,1/9/2024,202401090NSH,Nashville Predators,NSH,1,ANA,3,5,8,42,26,12,5,8,13,33,15,17
2023-24,1/9/2024,202401090NYI,Vancouver Canucks,VAN,0,NYI,5,6,11,34,20,10,2,2,4,20,31,17
2023-24,1/9/2024,202401090STL,St. Louis Blues,STL,1,FLA,1,2,3,30,14,8,5,8,13,31,29,10
2023-24,1/9/2024,202401090TBL,Tampa Bay Lightning,TBL,1,LAK,3,4,7,29,29,10,2,4,6,22,41,24
2023-24,1/9/2024,202401090TOR,Toronto Maple Leafs,TOR,1,SJS,7,14,21,46,19,7,1,2,3,23,49,22
2023-24,1/9/2024,202401090WPG,Winnipeg Jets,WPG,1,CBJ,5,7,12,23,10,23,0,0,0,29,15,21
2023-24,1/8/2024,202401080COL,Boston Bruins,BOS,0,COL,3,6,9,26,13,23,3,3,6,36,28,15
2023-24,1/8/2024,202401080MIN,Dallas Stars,DAL,0,MIN,4,5,9,20,17,16,0,0,0,23,30,14
2023-24,1/8/2024,202401080NYR,New York Rangers,NYR,1,VAN,3,4,7,42,30,9,6,12,18,26,19,13
2023-24,1/8/2024,202401080PHI,Philadelphia Flyers,PHI,1,PIT,1,2,3,37,32,10,4,7,11,39,12,16
2023-24,1/8/2024,202401080COL,Colorado Avalanche,COL,1,BOS,3,3,6,36,28,15,3,6,9,26,13,23
2023-24,1/8/2024,202401080MIN,Minnesota Wild,MIN,1,DAL,0,0,0,23,30,14,4,5,9,20,17,16
2023-24,1/8/2024,202401080NYR,Vancouver Canucks,VAN,0,NYR,6,12,18,26,19,13,3,4,7,42,30,9
2023-24,1/8/2024,202401080PHI,Pittsburgh Penguins,PIT,0,PHI,4,7,11,39,12,16,1,2,3,37,32,10
2023-24,1/7/2024,202401070ANA,Anaheim Ducks,ANA,1,DET,2,4,6,31,15,17,3,6,9,28,21,14
2023-24,1/7/2024,202401070ARI,Arizona Coyotes,ARI,1,WPG,2,2,4,17,25,19,6,6,12,37,22,14
2023-24,1/7/2024,202401070CHI,Calgary Flames,CGY,0,CHI,3,6,9,30,18,15,4,8,12,20,22,22
2023-24,1/7/2024,202401070WSH,Los Angeles Kings,LAK,0,WSH,3,5,8,41,27,17,4,7,11,34,39,13
2023-24,1/7/2024,202401070ANA,Detroit Red Wings,DET,0,ANA,3,6,9,28,21,14,2,4,6,31,15,17
2023-24,1/7/2024,202401070ARI,Winnipeg Jets,WPG,0,ARI,6,6,12,37,22,14,2,2,4,17,25,19
2023-24,1/7/2024,202401070CHI,Chicago Blackhawks,CHI,1,CGY,4,8,12,20,22,22,3,6,9,30,18,15
2023-24,1/7/2024,202401070WSH,Washington Capitals,WSH,1,LAK,4,7,11,34,39,13,3,5,8,41,27,17
2023-24,1/6/2024,202401060BOS,Boston Bruins,BOS,1,TBL,7,9,16,26,33,15,3,3,6,26,25,12
2023-24,1/6/2024,202401060CAR,Carolina Hurricanes,CAR,1,STL,1,1,2,30,15,13,1,2,3,22,10,25
2023-24,1/6/2024,202401060CBJ,Columbus Blue Jackets,CBJ,1,MIN,3,4,7,29,15,16,4,7,11,36,7,26
2023-24,1/6/2024,202401060COL,Colorado Avalanche,COL,1,FLA,4,7,11,26,18,17,8,15,23,29,14,6
2023-24,1/6/2024,202401060DAL,Dallas Stars,DAL,1,NSH,3,6,9,29,20,15,4,6,10,22,33,23
2023-24,1/6/2024,202401060EDM,Edmonton Oilers,EDM,1,OTT,3,5,8,46,15,17,1,2,3,30,31,15
2023-24,1/6/2024,202401060MTL,Montreal Canadiens,MTL,1,NYR,3,5,8,30,18,25,3,5,8,48,24,14
2023-24,1/6/2024,202401060NJD,New Jersey Devils,NJD,1,VAN,4,8,12,25,18,19,6,12,18,43,18,13
2023-24,1/6/2024,202401060PHI,Calgary Flames,CGY,0,PHI,2,4,6,24,10,23,3,6,9,42,22,21
2023-24,1/6/2024,202401060PIT,Buffalo Sabres,BUF,0,PIT,3,4,7,32,32,16,1,2,3,41,22,17
2023-24,1/6/2024,202401060SJS,San Jose Sharks,SJS,1,TOR,1,2,3,24,17,19,4,8,12,32,10,11
2023-24,1/6/2024,202401060VEG,New York Islanders,NYI,0,VEG,2,3,5,29,34,17,5,8,13,30,22,18
2023-24,1/6/2024,202401060BOS,Tampa Bay Lightning,TBL,0,BOS,3,3,6,26,25,12,7,9,16,26,33,15
2023-24,1/6/2024,202401060CAR,St. Louis Blues,STL,0,CAR,1,2,3,22,10,25,1,1,2,30,15,13
2023-24,1/6/2024,202401060CBJ,Minnesota Wild,MIN,0,CBJ,4,7,11,36,7,26,3,4,7,29,15,16
2023-24,1/6/2024,202401060COL,Florida Panthers,FLA,0,COL,8,15,23,29,14,6,4,7,11,26,18,17
2023-24,1/6/2024,202401060DAL,Nashville Predators,NSH,0,DAL,4,6,10,22,33,23,3,6,9,29,20,15
2023-24,1/6/2024,202401060EDM,Ottawa Senators,OTT,0,EDM,1,2,3,30,31,15,3,5,8,46,15,17
2023-24,1/6/2024,202401060MTL,New York Rangers,NYR,0,MTL,3,5,8,48,24,14,3,5,8,30,18,25
2023-24,1/6/2024,202401060NJD,Vancouver Canucks,VAN,0,NJD,6,12,18,43,18,13,4,8,12,25,18,19
2023-24,1/6/2024,202401060PHI,Philadelphia Flyers,PHI,1,CGY,3,6,9,42,22,21,2,4,6,24,10,23
2023-24,1/6/2024,202401060PIT,Pittsburgh Penguins,PIT,1,BUF,1,2,3,41,22,17,3,4,7,32,32,16
2023-24,1/6/2024,202401060SJS,Toronto Maple Leafs,TOR,0,SJS,4,8,12,32,10,11,1,2,3,24,17,19
2023-24,1/6/2024,202401060VEG,Vegas Golden Knights,VEG,1,NYI,5,8,13,30,22,18,2,3,5,29,34,17
2023-24,1/5/2024,202401050ANA,Anaheim Ducks,ANA,1,WPG,1,2,3,38,22,20,3,6,9,27,19,20
2023-24,1/5/2024,202401050NJD,Chicago Blackhawks,CHI,0,NJD,2,1,3,25,17,23,4,5,9,32,19,11
2023-24,1/5/2024,202401050WSH,Carolina Hurricanes,CAR,0,WSH,6,9,15,34,11,10,2,4,6,17,14,18
2023-24,1/5/2024,202401050ANA,Winnipeg Jets,WPG,0,ANA,3,6,9,27,19,20,1,2,3,38,22,20
2023-24,1/5/2024,202401050NJD,New Jersey Devils,NJD,1,CHI,4,5,9,32,19,11,2,1,3,25,17,23
2023-24,1/5/2024,202401050WSH,Washington Capitals,WSH,1,CAR,2,4,6,17,14,18,6,9,15,34,11,10
2023-24,1/4/2024,202401040ARI,Arizona Coyotes,ARI,1,NYI,1,2,3,27,18,9,5,7,12,31,25,15
2023-24,1/4/2024,202401040BOS,Boston Bruins,BOS,1,PIT,5,9,14,29,19,12,6,11,17,35,29,20
2023-24,1/4/2024,202401040DAL,Colorado Avalanche,COL,0,DAL,5,8,13,34,23,22,4,5,9,32,16,14
2023-24,1/4/2024,202401040LAK,Detroit Red Wings,DET,0,LAK,3,6,9,27,20,22,3,6,9,43,10,11
2023-24,1/4/2024,202401040MIN,Minnesota Wild,MIN,1,TBL,1,2,3,23,23,12,4,5,9,30,17,15
2023-24,1/4/2024,202401040MTL,Buffalo Sabres,BUF,0,MTL,6,12,18,38,31,17,1,0,1,33,26,14
2023-24,1/4/2024,202401040NSH,Calgary Flames,CGY,0,NSH,6,7,13,39,22,19,3,6,9,32,26,16
2023-24,1/4/2024,202401040NYR,Chicago Blackhawks,CHI,0,NYR,1,2,3,23,23,14,4,8,12,32,19,16
2023-24,1/4/2024,202401040PHI,Columbus Blue Jackets,CBJ,0,PHI,2,4,6,28,18,15,2,4,6,41,23,22
2023-24,1/4/2024,202401040SEA,Ottawa Senators,OTT,0,SEA,1,2,3,33,19,20,4,5,9,28,11,22
2023-24,1/4/2024,202401040SJS,San Jose Sharks,SJS,1,WPG,1,2,3,28,14,17,2,4,6,30,21,16
2023-24,1/4/2024,202401040STL,St. Louis Blues,STL,1,VAN,2,4,6,32,12,12,1,2,3,26,19,16
2023-24,1/4/2024,202401040VEG,Florida Panthers,FLA,0,VEG,4,8,12,36,34,12,1,1,2,27,20,15
2023-24,1/4/2024,202401040ARI,New York Islanders,NYI,0,ARI,5,7,12,31,25,15,1,2,3,27,18,9
2023-24,1/4/2024,202401040BOS,Pittsburgh Penguins,PIT,0,BOS,6,11,17,35,29,20,5,9,14,29,19,12
2023-24,1/4/2024,202401040DAL,Dallas Stars,DAL,1,COL,4,5,9,32,16,14,5,8,13,34,23,22
2023-24,1/4/2024,202401040LAK,Los Angeles Kings,LAK,1,DET,3,6,9,43,10,11,3,6,9,27,20,22
2023-24,1/4/2024,202401040MIN,Tampa Bay Lightning,TBL,0,MIN,4,5,9,30,17,15,1,2,3,23,23,12
2023-24,1/4/2024,202401040MTL,Montreal Canadiens,MTL,1,BUF,1,0,1,33,26,14,6,12,18,38,31,17
2023-24,1/4/2024,202401040NSH,Nashville Predators,NSH,1,CGY,3,6,9,32,26,16,6,7,13,39,22,19
2023-24,1/4/2024,202401040NYR,New York Rangers,NYR,1,CHI,4,8,12,32,19,16,1,2,3,23,23,14
2023-24,1/4/2024,202401040PHI,Philadelphia Flyers,PHI,1,CBJ,2,4,6,41,23,22,2,4,6,28,18,15
2023-24,1/4/2024,202401040SEA,Seattle Kraken,SEA,1,OTT,4,5,9,28,11,22,1,2,3,33,19,20
2023-24,1/4/2024,202401040SJS,Winnipeg Jets,WPG,0,SJS,2,4,6,30,21,16,1,2,3,28,14,17
2023-24,1/4/2024,202401040STL,Vancouver Canucks,VAN,0,STL,1,2,3,26,19,16,2,4,6,32,12,12
2023-24,1/4/2024,202401040VEG,Vegas Golden Knights,VEG,1,FLA,1,1,2,27,20,15,4,8,12,36,34,12
2023-24,1/3/2024,202401030ANA,Anaheim Ducks,ANA,1,TOR,1,2,3,28,20,24,2,4,6,57,16,12
2023-24,1/3/2024,202401030WSH,New Jersey Devils,NJD,0,WSH,6,10,16,28,17,8,3,6,9,26,29,19
2023-24,1/3/2024,202401030ANA,Toronto Maple Leafs,TOR,0,ANA,2,4,6,57,16,12,1,2,3,28,20,24
2023-24,1/3/2024,202401030WSH,Washington Capitals,WSH,1,NJD,3,6,9,26,29,19,6,10,16,28,17,8
2023-24,1/2/2024,202401020ARI,Arizona Coyotes,ARI,1,FLA,1,1,2,22,26,11,4,2,6,39,31,8
2023-24,1/2/2024,202401020CBJ,Boston Bruins,BOS,0,CBJ,4,6,10,27,16,13,1,2,3,27,17,15
2023-24,1/2/2024,202401020COL,Colorado Avalanche,COL,1,NYI,5,10,15,39,18,16,4,4,8,22,23,31
2023-24,1/2/2024,202401020DAL,Dallas Stars,DAL,1,MTL,3,5,8,33,18,9,4,6,10,18,27,25
2023-24,1/2/2024,202401020EDM,Edmonton Oilers,EDM,1,PHI,5,10,15,36,15,8,2,4,6,37,28,8
2023-24,1/2/2024,202401020LAK,Los Angeles Kings,LAK,1,TOR,0,0,0,31,19,22,3,4,7,29,27,26
2023-24,1/2/2024,202401020MIN,Calgary Flames,CGY,0,MIN,3,6,9,33,20,24,1,2,3,29,26,11
2023-24,1/2/2024,202401020NSH,Chicago Blackhawks,CHI,0,NSH,0,0,0,21,30,25,3,5,8,36,24,11
2023-24,1/2/2024,202401020NYR,Carolina Hurricanes,CAR,0,NYR,6,10,16,27,17,10,1,2,3,29,26,9
2023-24,1/2/2024,202401020PIT,Pittsburgh Penguins,PIT,1,WSH,3,6,9,35,31,9,4,7,11,22,17,23
2023-24,1/2/2024,202401020SJS,Detroit Red Wings,DET,0,SJS,5,7,12,31,19,29,3,5,8,27,26,16
2023-24,1/2/2024,202401020VAN,Ottawa Senators,OTT,0,VAN,3,6,9,38,29,20,6,9,15,26,23,17
2023-24,1/2/2024,202401020WPG,Tampa Bay Lightning,TBL,0,WPG,2,4,6,34,19,11,4,7,11,28,27,23
2023-24,1/2/2024,202401020ARI,Florida Panthers,FLA,0,ARI,4,2,6,39,31,8,1,1,2,22,26,11
2023-24,1/2/2024,202401020CBJ,Columbus Blue Jackets,CBJ,1,BOS,1,2,3,27,17,15,4,6,10,27,16,13
2023-24,1/2/2024,202401020COL,New York Islanders,NYI,0,COL,4,4,8,22,23,31,5,10,15,39,18,16
2023-24,1/2/2024,202401020DAL,Montreal Canadiens,MTL,0,DAL,4,6,10,18,27,25,3,5,8,33,18,9
2023-24,1/2/2024,202401020EDM,Philadelphia Flyers,PHI,0,EDM,2,4,6,37,28,8,5,10,15,36,15,8
2023-24,1/2/2024,202401020LAK,Toronto Maple Leafs,TOR,0,LAK,3,4,7,29,27,26,0,0,0,31,19,22
2023-24,1/2/2024,202401020MIN,Minnesota Wild,MIN,1,CGY,1,2,3,29,26,11,3,6,9,33,20,24
2023-24,1/2/2024,202401020NSH,Nashville Predators,NSH,1,CHI,3,5,8,36,24,11,0,0,0,21,30,25
2023-24,1/2/2024,202401020NYR,New York Rangers,NYR,1,CAR,1,2,3,29,26,9,6,10,16,27,17,10
2023-24,1/2/2024,202401020PIT,Washington Capitals,WSH,0,PIT,4,7,11,22,17,23,3,6,9,35,31,9
2023-24,1/2/2024,202401020SJS,San Jose Sharks,SJS,1,DET,3,5,8,27,26,16,5,7,12,31,19,29
2023-24,1/2/2024,202401020VAN,Vancouver Canucks,VAN,1,OTT,6,9,15,26,23,17,3,6,9,38,29,20
2023-24,1/2/2024,202401020WPG,Winnipeg Jets,WPG,1,TBL,4,7,11,28,27,23,2,4,6,34,19,11
2023-24,1/1/2024,202401010SEA,Seattle Kraken,SEA,1,VEG,3,4,7,27,30,20,0,0,0,35,23,20
2023-24,1/1/2024,202401010SEA,Vegas Golden Knights,VEG,0,SEA,0,0,0,35,23,20,3,4,7,27,30,20
2023-24,12/31/2023,202312310ANA,Anaheim Ducks,ANA,1,EDM,2,4,6,30,30,15,7,11,18,39,14,10
2023-24,12/31/2023,202312310CGY,Calgary Flames,CGY,1,PHI,4,6,10,33,16,20,3,6,9,31,22,15
2023-24,12/31/2023,202312310COL,Colorado Avalanche,COL,1,SJS,3,6,9,33,24,10,1,2,3,11,21,28
2023-24,12/31/2023,202312310DAL,Chicago Blackhawks,CHI,0,DAL,1,2,3,24,29,13,8,16,24,41,5,16
2023-24,12/31/2023,202312310DET,Boston Bruins,BOS,0,DET,5,10,15,24,21,17,3,6,9,30,17,13
2023-24,12/31/2023,202312310MIN,Minnesota Wild,MIN,1,WPG,2,4,6,26,36,16,3,6,9,29,17,28
2023-24,12/31/2023,202312310OTT,Buffalo Sabres,BUF,0,OTT,1,1,2,46,33,13,5,7,12,31,24,17
2023-24,12/31/2023,202312310PIT,New York Islanders,NYI,0,PIT,1,0,1,38,27,25,3,3,6,38,14,18
2023-24,12/31/2023,202312310TBL,Montreal Canadiens,MTL,0,TBL,3,2,5,29,30,17,4,8,12,20,31,17
2023-24,12/31/2023,202312310ANA,Edmonton Oilers,EDM,0,ANA,7,11,18,39,14,10,2,4,6,30,30,15
2023-24,12/31/2023,202312310CGY,Philadelphia Flyers,PHI,0,CGY,3,6,9,31,22,15,4,6,10,33,16,20
2023-24,12/31/2023,202312310COL,San Jose Sharks,SJS,0,COL,1,2,3,11,21,28,3,6,9,33,24,10
2023-24,12/31/2023,202312310DAL,Dallas Stars,DAL,1,CHI,8,16,24,41,5,16,1,2,3,24,29,13
2023-24,12/31/2023,202312310DET,Detroit Red Wings,DET,1,BOS,3,6,9,30,17,13,5,10,15,24,21,17
2023-24,12/31/2023,202312310MIN,Winnipeg Jets,WPG,0,MIN,3,6,9,29,17,28,2,4,6,26,36,16
2023-24,12/31/2023,202312310OTT,Ottawa Senators,OTT,1,BUF,5,7,12,31,24,17,1,1,2,46,33,13
2023-24,12/31/2023,202312310PIT,Pittsburgh Penguins,PIT,1,NYI,3,3,6,38,14,18,1,0,1,38,27,25
2023-24,12/31/2023,202312310TBL,Tampa Bay Lightning,TBL,1,MTL,4,8,12,20,31,17,3,2,5,29,30,17
2023-24,12/30/2023,202312300BOS,Boston Bruins,BOS,1,NJD,5,10,15,31,39,14,2,4,6,33,33,13
2023-24,12/30/2023,202312300BUF,Buffalo Sabres,BUF,1,CBJ,3,6,9,42,15,6,2,4,6,20,18,21
2023-24,12/30/2023,202312300FLA,Florida Panthers,FLA,1,MTL,4,8,12,26,19,13,1,2,3,19,19,17
2023-24,12/30/2023,202312300LAK,Edmonton Oilers,EDM,0,LAK,2,3,5,26,22,16,2,4,6,28,29,12
2023-24,12/30/2023,202312300PIT,Pittsburgh Penguins,PIT,1,STL,4,7,11,30,21,21,2,3,5,27,16,18
2023-24,12/30/2023,202312300TBL,New York Rangers,NYR,0,TBL,5,9,14,21,27,23,1,2,3,35,20,7
2023-24,12/30/2023,202312300TOR,Carolina Hurricanes,CAR,0,TOR,3,4,7,28,27,12,2,4,6,27,28,11
2023-24,12/30/2023,202312300WPG,Minnesota Wild,MIN,0,WPG,2,3,5,36,20,17,4,6,10,32,25,17
2023-24,12/30/2023,202312300WSH,Nashville Predators,NSH,0,WSH,2,4,6,36,25,17,2,4,6,29,21,21
2023-24,12/30/2023,202312300BOS,New Jersey Devils,NJD,0,BOS,2,4,6,33,33,13,5,10,15,31,39,14
2023-24,12/30/2023,202312300BUF,Columbus Blue Jackets,CBJ,0,BUF,2,4,6,20,18,21,3,6,9,42,15,6
2023-24,12/30/2023,202312300FLA,Montreal Canadiens,MTL,0,FLA,1,2,3,19,19,17,4,8,12,26,19,13
2023-24,12/30/2023,202312300LAK,Los Angeles Kings,LAK,1,EDM,2,4,6,28,29,12,2,3,5,26,22,16
2023-24,12/30/2023,202312300PIT,St. Louis Blues,STL,0,PIT,2,3,5,27,16,18,4,7,11,30,21,21
2023-24,12/30/2023,202312300TBL,Tampa Bay Lightning,TBL,1,NYR,1,2,3,35,20,7,5,9,14,21,27,23
2023-24,12/30/2023,202312300TOR,Toronto Maple Leafs,TOR,1,CAR,2,4,6,27,28,11,3,4,7,28,27,12
2023-24,12/30/2023,202312300WPG,Winnipeg Jets,WPG,1,MIN,4,6,10,32,25,17,2,3,5,36,20,17
2023-24,12/30/2023,202312300WSH,Washington Capitals,WSH,1,NSH,2,4,6,29,21,21,2,4,6,36,25,17
2023-24,12/29/2023,202312290ANA,Anaheim Ducks,ANA,1,ARI,0,0,0,28,29,18,2,3,5,32,15,13
2023-24,12/29/2023,202312290CBJ,Columbus Blue Jackets,CBJ,1,TOR,6,9,15,21,14,12,5,8,13,33,13,17
2023-24,12/29/2023,202312290DAL,Chicago Blackhawks,CHI,0,DAL,4,8,12,29,31,23,5,9,14,35,13,14
2023-24,12/29/2023,202312290DET,Detroit Red Wings,DET,1,NSH,5,8,13,23,25,18,4,4,8,37,22,15
2023-24,12/29/2023,202312290FLA,Florida Panthers,FLA,1,NYR,4,8,12,33,34,12,3,4,7,34,24,23
2023-24,12/29/2023,202312290NYI,New York Islanders,NYI,1,WSH,5,9,14,32,25,8,1,2,3,27,15,16
2023-24,12/29/2023,202312290OTT,New Jersey Devils,NJD,0,OTT,6,10,16,30,14,14,2,3,5,27,27,20
2023-24,12/29/2023,202312290SEA,Philadelphia Flyers,PHI,0,SEA,1,2,3,28,16,21,2,4,6,29,22,14
2023-24,12/29/2023,202312290STL,Colorado Avalanche,COL,0,STL,2,4,6,23,13,9,1,0,1,29,16,9
2023-24,12/29/2023,202312290ANA,Arizona Coyotes,ARI,0,ANA,2,3,5,32,15,13,0,0,0,28,29,18
2023-24,12/29/2023,202312290CBJ,Toronto Maple Leafs,TOR,0,CBJ,5,8,13,33,13,17,6,9,15,21,14,12
2023-24,12/29/2023,202312290DAL,Dallas Stars,DAL,1,CHI,5,9,14,35,13,14,4,8,12,29,31,23
2023-24,12/29/2023,202312290DET,Nashville Predators,NSH,0,DET,4,4,8,37,22,15,5,8,13,23,25,18
2023-24,12/29/2023,202312290FLA,New York Rangers,NYR,0,FLA,3,4,7,34,24,23,4,8,12,33,34,12
2023-24,12/29/2023,202312290NYI,Washington Capitals,WSH,0,NYI,1,2,3,27,15,16,5,9,14,32,25,8
2023-24,12/29/2023,202312290OTT,Ottawa Senators,OTT,1,NJD,2,3,5,27,27,20,6,10,16,30,14,14
2023-24,12/29/2023,202312290SEA,Seattle Kraken,SEA,1,PHI,2,4,6,29,22,14,1,2,3,28,16,21
2023-24,12/29/2023,202312290STL,St. Louis Blues,STL,1,COL,1,0,1,29,16,9,2,4,6,23,13,9
2023-24,12/28/2023,202312280CAR,Carolina Hurricanes,CAR,1,MTL,5,10,15,31,19,13,3,3,6,21,17,26
2023-24,12/28/2023,202312280SJS,Edmonton Oilers,EDM,0,SJS,5,10,15,30,11,12,0,0,0,25,19,15
2023-24,12/28/2023,202312280VAN,Philadelphia Flyers,PHI,0,VAN,4,6,10,25,17,18,1,2,3,27,22,13
2023-24,12/28/2023,202312280VEG,Los Angeles Kings,LAK,0,VEG,2,4,6,34,26,9,3,6,9,32,24,34
2023-24,12/28/2023,202312280CAR,Montreal Canadiens,MTL,0,CAR,3,3,6,21,17,26,5,10,15,31,19,13
2023-24,12/28/2023,202312280SJS,San Jose Sharks,SJS,1,EDM,0,0,0,25,19,15,5,10,15,30,11,12
2023-24,12/28/2023,202312280VAN,Vancouver Canucks,VAN,1,PHI,1,2,3,27,22,13,4,6,10,25,17,18
2023-24,12/28/2023,202312280VEG,Vegas Golden Knights,VEG,1,LAK,3,6,9,32,24,34,2,4,6,34,26,9
2023-24,12/27/2023,202312270ANA,Anaheim Ducks,ANA,1,VEG,5,10,15,26,24,29,2,3,5,32,19,9
2023-24,12/27/2023,202312270ARI,Arizona Coyotes,ARI,1,COL,5,9,14,27,33,9,4,8,12,24,36,15
2023-24,12/27/2023,202312270BUF,Boston Bruins,BOS,0,BUF,4,8,12,25,13,20,1,2,3,26,17,10
2023-24,12/27/2023,202312270CGY,Calgary Flames,CGY,1,SEA,1,1,2,38,18,19,2,4,6,21,20,20
2023-24,12/27/2023,202312270CHI,Chicago Blackhawks,CHI,1,WPG,2,4,6,25,25,21,1,2,3,38,25,12
2023-24,12/27/2023,202312270LAK,Los Angeles Kings,LAK,1,SJS,5,7,12,43,20,20,1,0,1,25,26,16
2023-24,12/27/2023,202312270MIN,Detroit Red Wings,DET,0,MIN,3,5,8,28,19,8,6,7,13,31,29,16
2023-24,12/27/2023,202312270NJD,Columbus Blue Jackets,CBJ,0,NJD,3,4,7,29,25,23,4,5,9,35,19,21
2023-24,12/27/2023,202312270NSH,Carolina Hurricanes,CAR,0,NSH,5,9,14,25,23,10,2,3,5,37,37,17
2023-24,12/27/2023,202312270NYI,New York Islanders,NYI,1,PIT,0,0,0,22,22,18,7,14,21,32,16,13
2023-24,12/27/2023,202312270NYR,New York Rangers,NYR,1,WSH,5,10,15,31,28,15,1,2,3,27,17,6
2023-24,12/27/2023,202312270STL,Dallas Stars,DAL,0,STL,1,1,2,40,12,13,2,3,5,30,19,19
2023-24,12/27/2023,202312270TBL,Florida Panthers,FLA,0,TBL,3,5,8,31,36,11,2,4,6,29,27,18
2023-24,12/27/2023,202312270TOR,Ottawa Senators,OTT,0,TOR,4,5,9,30,31,24,2,3,5,36,31,11
2023-24,12/27/2023,202312270ANA,Vegas Golden Knights,VEG,0,ANA,2,3,5,32,19,9,5,10,15,26,24,29
2023-24,12/27/2023,202312270ARI,Colorado Avalanche,COL,0,ARI,4,8,12,24,36,15,5,9,14,27,33,9
2023-24,12/27/2023,202312270BUF,Buffalo Sabres,BUF,1,BOS,1,2,3,26,17,10,4,8,12,25,13,20
2023-24,12/27/2023,202312270CGY,Seattle Kraken,SEA,0,CGY,2,4,6,21,20,20,1,1,2,38,18,19
2023-24,12/27/2023,202312270CHI,Winnipeg Jets,WPG,0,CHI,1,2,3,38,25,12,2,4,6,25,25,21
2023-24,12/27/2023,202312270LAK,San Jose Sharks,SJS,0,LAK,1,0,1,25,26,16,5,7,12,43,20,20
2023-24,12/27/2023,202312270MIN,Minnesota Wild,MIN,1,DET,6,7,13,31,29,16,3,5,8,28,19,8
2023-24,12/27/2023,202312270NJD,New Jersey Devils,NJD,1,CBJ,4,5,9,35,19,21,3,4,7,29,25,23
2023-24,12/27/2023,202312270NSH,Nashville Predators,NSH,1,CAR,2,3,5,37,37,17,5,9,14,25,23,10
2023-24,12/27/2023,202312270NYI,Pittsburgh Penguins,PIT,0,NYI,7,14,21,32,16,13,0,0,0,22,22,18
2023-24,12/27/2023,202312270NYR,Washington Capitals,WSH,0,NYR,1,2,3,27,17,6,5,10,15,31,28,15
2023-24,12/27/2023,202312270STL,St. Louis Blues,STL,1,DAL,2,3,5,30,19,19,1,1,2,40,12,13
2023-24,12/27/2023,202312270TBL,Tampa Bay Lightning,TBL,1,FLA,2,4,6,29,27,18,3,5,8,31,36,11
2023-24,12/27/2023,202312270TOR,Toronto Maple Leafs,TOR,1,OTT,2,3,5,36,31,11,4,5,9,30,31,24
2023-24,12/23/2023,202312230ANA,Anaheim Ducks,ANA,1,SEA,2,2,4,34,24,18,3,6,9,22,18,12
2023-24,12/23/2023,202312230CAR,Carolina Hurricanes,CAR,1,NYI,4,8,12,40,19,8,5,10,15,28,14,24
2023-24,12/23/2023,202312230CBJ,Columbus Blue Jackets,CBJ,1,TOR,1,2,3,28,7,13,4,7,11,30,9,19
2023-24,12/23/2023,202312230COL,Arizona Coyotes,ARI,0,COL,1,2,3,25,23,9,4,7,11,26,23,6
2023-24,12/23/2023,202312230FLA,Florida Panthers,FLA,1,VEG,4,7,11,42,39,11,2,3,5,25,25,21
2023-24,12/23/2023,202312230LAK,Calgary Flames,CGY,0,LAK,3,5,8,32,14,26,5,9,14,34,23,25
2023-24,12/23/2023,202312230MIN,Boston Bruins,BOS,0,MIN,2,4,6,21,21,12,3,4,7,36,26,11
2023-24,12/23/2023,202312230NJD,Detroit Red Wings,DET,0,NJD,2,4,6,24,13,13,3,2,5,36,18,10
2023-24,12/23/2023,202312230NSH,Dallas Stars,DAL,0,NSH,3,4,7,34,23,12,2,4,6,21,40,27
2023-24,12/23/2023,202312230NYR,Buffalo Sabres,BUF,0,NYR,3,4,7,30,18,26,4,7,11,33,13,13
2023-24,12/23/2023,202312230OTT,Ottawa Senators,OTT,1,PIT,5,9,14,26,16,28,4,8,12,34,16,11
2023-24,12/23/2023,202312230STL,Chicago Blackhawks,CHI,0,STL,5,9,14,20,36,13,7,10,17,42,21,12
2023-24,12/23/2023,202312230VAN,San Jose Sharks,SJS,0,VAN,4,8,12,25,19,22,7,11,18,26,19,9
2023-24,12/23/2023,202312230WSH,Tampa Bay Lightning,TBL,0,WSH,1,1,2,20,19,21,1,2,3,34,24,17
2023-24,12/23/2023,202312230ANA,Seattle Kraken,SEA,0,ANA,3,6,9,22,18,12,2,2,4,34,24,18
2023-24,12/23/2023,202312230CAR,New York Islanders,NYI,0,CAR,5,10,15,28,14,24,4,8,12,40,19,8
2023-24,12/23/2023,202312230CBJ,Toronto Maple Leafs,TOR,0,CBJ,4,7,11,30,9,19,1,2,3,28,7,13
2023-24,12/23/2023,202312230COL,Colorado Avalanche,COL,1,ARI,4,7,11,26,23,6,1,2,3,25,23,9
2023-24,12/23/2023,202312230FLA,Vegas Golden Knights,VEG,0,FLA,2,3,5,25,25,21,4,7,11,42,39,11
2023-24,12/23/2023,202312230LAK,Los Angeles Kings,LAK,1,CGY,5,9,14,34,23,25,3,5,8,32,14,26
2023-24,12/23/2023,202312230MIN,Minnesota Wild,MIN,1,BOS,3,4,7,36,26,11,2,4,6,21,21,12
2023-24,12/23/2023,202312230NJD,New Jersey Devils,NJD,1,DET,3,2,5,36,18,10,2,4,6,24,13,13
2023-24,12/23/2023,202312230NSH,Nashville Predators,NSH,1,DAL,2,4,6,21,40,27,3,4,7,34,23,12
2023-24,12/23/2023,202312230NYR,New York Rangers,NYR,1,BUF,4,7,11,33,13,13,3,4,7,30,18,26
2023-24,12/23/2023,202312230OTT,Pittsburgh Penguins,PIT,0,OTT,4,8,12,34,16,11,5,9,14,26,16,28
2023-24,12/23/2023,202312230STL,St. Louis Blues,STL,1,CHI,7,10,17,42,21,12,5,9,14,20,36,13
2023-24,12/23/2023,202312230VAN,Vancouver Canucks,VAN,1,SJS,7,11,18,26,19,9,4,8,12,25,19,22
2023-24,12/23/2023,202312230WSH,Washington Capitals,WSH,1,TBL,1,2,3,34,24,17,1,1,2,20,19,21
2023-24,12/22/2023,202312220CHI,Chicago Blackhawks,CHI,1,MTL,2,4,6,21,26,22,5,8,13,28,12,17
2023-24,12/22/2023,202312220DET,Detroit Red Wings,DET,1,PHI,6,12,18,37,16,12,6,12,18,43,18,18
2023-24,12/22/2023,202312220NYR,Edmonton Oilers,EDM,0,NYR,4,6,10,28,14,24,3,4,7,34,16,15
2023-24,12/22/2023,202312220WPG,Boston Bruins,BOS,0,WPG,1,0,1,25,27,17,5,9,14,33,25,15
2023-24,12/22/2023,202312220CHI,Montreal Canadiens,MTL,0,CHI,5,8,13,28,12,17,2,4,6,21,26,22
2023-24,12/22/2023,202312220DET,Philadelphia Flyers,PHI,0,DET,6,12,18,43,18,18,6,12,18,37,16,12
2023-24,12/22/2023,202312220NYR,New York Rangers,NYR,1,EDM,3,4,7,34,16,15,4,6,10,28,14,24
2023-24,12/22/2023,202312220WPG,Winnipeg Jets,WPG,1,BOS,5,9,14,33,25,15,1,0,1,25,27,17
2023-24,12/21/2023,202312210ANA,Anaheim Ducks,ANA,1,CGY,0,0,0,25,16,15,3,5,8,44,14,20
2023-24,12/21/2023,202312210BUF,Buffalo Sabres,BUF,1,TOR,9,15,24,34,28,19,3,4,7,27,20,14
2023-24,12/21/2023,202312210CBJ,Columbus Blue Jackets,CBJ,1,WSH,2,4,6,36,11,21,3,6,9,32,9,15
2023-24,12/21/2023,202312210COL,Colorado Avalanche,COL,1,OTT,6,8,14,39,25,19,4,8,12,45,17,7
2023-24,12/21/2023,202312210DAL,Dallas Stars,DAL,1,VAN,4,8,12,36,20,14,3,6,9,20,21,10
2023-24,12/21/2023,202312210FLA,Florida Panthers,FLA,1,STL,1,1,2,38,21,3,4,8,12,24,24,16
2023-24,12/21/2023,202312210MIN,Minnesota Wild,MIN,1,MTL,4,8,12,24,21,11,3,6,9,25,17,14
2023-24,12/21/2023,202312210NJD,Edmonton Oilers,EDM,0,NJD,6,6,12,38,17,15,3,4,7,26,32,18
2023-24,12/21/2023,202312210PHI,Nashville Predators,NSH,0,PHI,4,5,9,31,24,10,2,2,4,31,22,12
2023-24,12/21/2023,202312210PIT,Carolina Hurricanes,CAR,0,PIT,1,2,3,24,16,19,1,2,3,25,26,27
2023-24,12/21/2023,202312210SJS,Arizona Coyotes,ARI,0,SJS,5,9,14,30,13,18,2,3,5,31,11,18
2023-24,12/21/2023,202312210TBL,Tampa Bay Lightning,TBL,1,VEG,5,10,15,36,26,14,4,8,12,34,24,23
2023-24,12/21/2023,202312210ANA,Calgary Flames,CGY,0,ANA,3,5,8,44,14,20,0,0,0,25,16,15
2023-24,12/21/2023,202312210BUF,Toronto Maple Leafs,TOR,0,BUF,3,4,7,27,20,14,9,15,24,34,28,19
2023-24,12/21/2023,202312210CBJ,Washington Capitals,WSH,0,CBJ,3,6,9,32,9,15,2,4,6,36,11,21
2023-24,12/21/2023,202312210COL,Ottawa Senators,OTT,0,COL,4,8,12,45,17,7,6,8,14,39,25,19
2023-24,12/21/2023,202312210DAL,Vancouver Canucks,VAN,0,DAL,3,6,9,20,21,10,4,8,12,36,20,14
2023-24,12/21/2023,202312210FLA,St. Louis Blues,STL,0,FLA,4,8,12,24,24,16,1,1,2,38,21,3
2023-24,12/21/2023,202312210MIN,Montreal Canadiens,MTL,0,MIN,3,6,9,25,17,14,4,8,12,24,21,11
2023-24,12/21/2023,202312210NJD,New Jersey Devils,NJD,1,EDM,3,4,7,26,32,18,6,6,12,38,17,15
2023-24,12/21/2023,202312210PHI,Philadelphia Flyers,PHI,1,NSH,2,2,4,31,22,12,4,5,9,31,24,10
2023-24,12/21/2023,202312210PIT,Pittsburgh Penguins,PIT,1,CAR,1,2,3,25,26,27,1,2,3,24,16,19
2023-24,12/21/2023,202312210SJS,San Jose Sharks,SJS,1,ARI,2,3,5,31,11,18,5,9,14,30,13,18
2023-24,12/21/2023,202312210TBL,Vegas Golden Knights,VEG,0,TBL,4,8,12,34,24,23,5,10,15,36,26,14
2023-24,12/20/2023,202312200LAK,Los Angeles Kings,LAK,1,SEA,1,0,1,43,14,19,2,2,4,30,34,13
2023-24,12/20/2023,202312200WPG,Detroit Red Wings,DET,0,WPG,2,4,6,28,15,11,5,9,14,41,20,20
2023-24,12/20/2023,202312200WSH,New York Islanders,NYI,0,WSH,2,1,3,32,19,19,3,5,8,36,17,17
2023-24,12/20/2023,202312200LAK,Seattle Kraken,SEA,0,LAK,2,2,4,30,34,13,1,0,1,43,14,19
2023-24,12/20/2023,202312200WPG,Winnipeg Jets,WPG,1,DET,5,9,14,41,20,20,2,4,6,28,15,11
2023-24,12/20/2023,202312200WSH,Washington Capitals,WSH,1,NYI,3,5,8,36,17,17,2,1,3,32,19,19
2023-24,12/19/2023,202312190ARI,Arizona Coyotes,ARI,1,OTT,4,8,12,38,32,13,3,5,8,22,28,20
2023-24,12/19/2023,202312190BOS,Boston Bruins,BOS,1,MIN,3,5,8,43,38,12,4,6,10,30,25,10
2023-24,12/19/2023,202312190BUF,Buffalo Sabres,BUF,1,CBJ,4,8,12,29,26,13,9,17,26,34,13,16
2023-24,12/19/2023,202312190CAR,Carolina Hurricanes,CAR,1,VEG,6,10,16,39,13,10,3,6,9,33,21,12
2023-24,12/19/2023,202312190CHI,Chicago Blackhawks,CHI,1,COL,3,6,9,22,26,14,2,4,6,37,19,6
2023-24,12/19/2023,202312190NJD,New Jersey Devils,NJD,1,PHI,2,4,6,26,39,12,3,3,6,26,44,21
2023-24,12/19/2023,202312190NSH,Nashville Predators,NSH,1,VAN,2,3,5,28,28,3,5,7,12,35,22,17
2023-24,12/19/2023,202312190NYI,Edmonton Oilers,EDM,0,NYI,1,2,3,31,13,8,3,5,8,21,29,22
2023-24,12/19/2023,202312190SJS,Los Angeles Kings,LAK,0,SJS,4,7,11,39,13,16,1,2,3,16,8,15
2023-24,12/19/2023,202312190TBL,St. Louis Blues,STL,0,TBL,1,2,3,29,22,14,6,12,18,33,14,19
2023-24,12/19/2023,202312190TOR,New York Rangers,NYR,0,TOR,5,10,15,36,41,15,2,4,6,33,20,17
2023-24,12/19/2023,202312190ARI,Ottawa Senators,OTT,0,ARI,3,5,8,22,28,20,4,8,12,38,32,13
2023-24,12/19/2023,202312190BOS,Minnesota Wild,MIN,0,BOS,4,6,10,30,25,10,3,5,8,43,38,12
2023-24,12/19/2023,202312190BUF,Columbus Blue Jackets,CBJ,0,BUF,9,17,26,34,13,16,4,8,12,29,26,13
2023-24,12/19/2023,202312190CAR,Vegas Golden Knights,VEG,0,CAR,3,6,9,33,21,12,6,10,16,39,13,10
2023-24,12/19/2023,202312190CHI,Colorado Avalanche,COL,0,CHI,2,4,6,37,19,6,3,6,9,22,26,14
2023-24,12/19/2023,202312190NJD,Philadelphia Flyers,PHI,0,NJD,3,3,6,26,44,21,2,4,6,26,39,12
2023-24,12/19/2023,202312190NSH,Vancouver Canucks,VAN,0,NSH,5,7,12,35,22,17,2,3,5,28,28,3
2023-24,12/19/2023,202312190NYI,New York Islanders,NYI,1,EDM,3,5,8,21,29,22,1,2,3,31,13,8
2023-24,12/19/2023,202312190SJS,San Jose Sharks,SJS,1,LAK,1,2,3,16,8,15,4,7,11,39,13,16
2023-24,12/19/2023,202312190TBL,Tampa Bay Lightning,TBL,1,STL,6,12,18,33,14,19,1,2,3,29,22,14
2023-24,12/19/2023,202312190TOR,Toronto Maple Leafs,TOR,1,NYR,2,4,6,33,20,17,5,10,15,36,41,15
2023-24,12/18/2023,202312180CGY,Calgary Flames,CGY,1,FLA,3,3,6,25,18,28,1,2,3,34,19,10
2023-24,12/18/2023,202312180DAL,Dallas Stars,DAL,1,SEA,4,8,12,28,21,13,3,5,8,38,28,12
2023-24,12/18/2023,202312180DET,Anaheim Ducks,ANA,0,DET,4,8,12,22,16,23,3,6,9,32,23,11
2023-24,12/18/2023,202312180PIT,Minnesota Wild,MIN,0,PIT,3,6,9,27,17,12,4,8,12,30,9,13
2023-24,12/18/2023,202312180WPG,Montreal Canadiens,MTL,0,WPG,3,6,9,25,29,23,2,4,6,32,21,13
2023-24,12/18/2023,202312180CGY,Florida Panthers,FLA,0,CGY,1,2,3,34,19,10,3,3,6,25,18,28
2023-24,12/18/2023,202312180DAL,Seattle Kraken,SEA,0,DAL,3,5,8,38,28,12,4,8,12,28,21,13
2023-24,12/18/2023,202312180DET,Detroit Red Wings,DET,1,ANA,3,6,9,32,23,11,4,8,12,22,16,23
2023-24,12/18/2023,202312180PIT,Pittsburgh Penguins,PIT,1,MIN,4,8,12,30,9,13,3,6,9,27,17,12
2023-24,12/18/2023,202312180WPG,Winnipeg Jets,WPG,1,MTL,2,4,6,32,21,13,3,6,9,25,29,23
2023-24,12/17/2023,202312170CAR,Carolina Hurricanes,CAR,1,WSH,1,1,2,29,10,8,1,2,3,21,19,14
2023-24,12/17/2023,202312170CHI,Chicago Blackhawks,CHI,1,VAN,3,5,8,28,11,15,4,8,12,27,14,8
2023-24,12/17/2023,202312170COL,Colorado Avalanche,COL,1,SJS,6,8,14,29,20,21,2,4,6,27,29,15
2023-24,12/17/2023,202312170NJD,Anaheim Ducks,ANA,0,NJD,5,8,13,28,15,17,1,2,3,29,12,10
2023-24,12/17/2023,202312170VEG,Ottawa Senators,OTT,0,VEG,3,6,9,25,41,12,6,10,16,31,25,18
2023-24,12/17/2023,202312170CAR,Washington Capitals,WSH,0,CAR,1,2,3,21,19,14,1,1,2,29,10,8
2023-24,12/17/2023,202312170CHI,Vancouver Canucks,VAN,0,CHI,4,8,12,27,14,8,3,5,8,28,11,15
2023-24,12/17/2023,202312170COL,San Jose Sharks,SJS,0,COL,2,4,6,27,29,15,6,8,14,29,20,21
2023-24,12/17/2023,202312170NJD,New Jersey Devils,NJD,1,ANA,1,2,3,29,12,10,5,8,13,28,15,17
2023-24,12/17/2023,202312170VEG,Vegas Golden Knights,VEG,1,OTT,6,10,16,31,25,18,3,6,9,25,41,12
2023-24,12/16/2023,202312160ARI,Arizona Coyotes,ARI,1,BUF,2,2,4,22,23,19,0,0,0,28,16,20
2023-24,12/16/2023,202312160BOS,Boston Bruins,BOS,1,NYR,1,2,3,22,24,14,2,4,6,34,23,16
2023-24,12/16/2023,202312160CBJ,Columbus Blue Jackets,CBJ,1,NJD,3,5,8,26,14,15,6,7,13,30,12,12
2023-24,12/16/2023,202312160CGY,Calgary Flames,CGY,1,TBL,4,7,11,26,20,16,2,3,5,33,20,20
2023-24,12/16/2023,202312160EDM,Edmonton Oilers,EDM,1,FLA,1,2,3,39,41,14,5,8,13,39,26,14
2023-24,12/16/2023,202312160MIN,Minnesota Wild,MIN,1,VAN,1,2,3,31,16,16,1,2,3,36,15,11
2023-24,12/16/2023,202312160MTL,Montreal Canadiens,MTL,1,NYI,5,9,14,41,20,18,3,4,7,33,27,14
2023-24,12/16/2023,202312160NSH,Nashville Predators,NSH,1,WSH,3,5,8,23,29,18,1,2,3,22,20,11
2023-24,12/16/2023,202312160PHI,Detroit Red Wings,DET,0,PHI,0,0,0,32,19,10,1,2,3,34,22,21
2023-24,12/16/2023,202312160SEA,Los Angeles Kings,LAK,0,SEA,2,4,6,38,22,12,2,4,6,19,19,18
2023-24,12/16/2023,202312160STL,Dallas Stars,DAL,0,STL,3,6,9,23,15,12,4,8,12,34,27,15
2023-24,12/16/2023,202312160TOR,Pittsburgh Penguins,PIT,0,TOR,0,0,0,38,38,14,7,13,20,35,16,19
2023-24,12/16/2023,202312160WPG,Colorado Avalanche,COL,0,WPG,2,4,6,32,31,17,6,9,15,25,21,16
2023-24,12/16/2023,202312160ARI,Buffalo Sabres,BUF,0,ARI,0,0,0,28,16,20,2,2,4,22,23,19
2023-24,12/16/2023,202312160BOS,New York Rangers,NYR,0,BOS,2,4,6,34,23,16,1,2,3,22,24,14
2023-24,12/16/2023,202312160CBJ,New Jersey Devils,NJD,0,CBJ,6,7,13,30,12,12,3,5,8,26,14,15
2023-24,12/16/2023,202312160CGY,Tampa Bay Lightning,TBL,0,CGY,2,3,5,33,20,20,4,7,11,26,20,16
2023-24,12/16/2023,202312160EDM,Florida Panthers,FLA,0,EDM,5,8,13,39,26,14,1,2,3,39,41,14
2023-24,12/16/2023,202312160MIN,Vancouver Canucks,VAN,0,MIN,1,2,3,36,15,11,1,2,3,31,16,16
2023-24,12/16/2023,202312160MTL,New York Islanders,NYI,0,MTL,3,4,7,33,27,14,5,9,14,41,20,18
2023-24,12/16/2023,202312160NSH,Washington Capitals,WSH,0,NSH,1,2,3,22,20,11,3,5,8,23,29,18
2023-24,12/16/2023,202312160PHI,Philadelphia Flyers,PHI,1,DET,1,2,3,34,22,21,0,0,0,32,19,10
2023-24,12/16/2023,202312160SEA,Seattle Kraken,SEA,1,LAK,2,4,6,19,19,18,2,4,6,38,22,12
2023-24,12/16/2023,202312160STL,St. Louis Blues,STL,1,DAL,4,8,12,34,27,15,3,6,9,23,15,12
2023-24,12/16/2023,202312160TOR,Toronto Maple Leafs,TOR,1,PIT,7,13,20,35,16,19,0,0,0,38,38,14
2023-24,12/16/2023,202312160WPG,Winnipeg Jets,WPG,1,COL,6,9,15,25,21,16,2,4,6,32,31,17
2023-24,12/15/2023,202312150ARI,Arizona Coyotes,ARI,1,SJS,1,2,3,24,19,15,0,0,0,21,24,15
2023-24,12/15/2023,202312150CAR,Carolina Hurricanes,CAR,1,NSH,5,7,12,31,25,15,6,11,17,30,23,20
2023-24,12/15/2023,202312150DAL,Dallas Stars,DAL,1,OTT,5,8,13,24,21,14,4,8,12,29,30,13
2023-24,12/15/2023,202312150NYI,Boston Bruins,BOS,0,NYI,4,6,10,34,27,7,4,7,11,37,41,18
2023-24,12/15/2023,202312150NYR,Anaheim Ducks,ANA,0,NYR,1,1,2,30,15,19,5,8,13,39,15,9
2023-24,12/15/2023,202312150VEG,Buffalo Sabres,BUF,0,VEG,5,8,13,27,30,19,2,2,4,35,44,12
2023-24,12/15/2023,202312150ARI,San Jose Sharks,SJS,0,ARI,0,0,0,21,24,15,1,2,3,24,19,15
2023-24,12/15/2023,202312150CAR,Nashville Predators,NSH,0,CAR,6,11,17,30,23,20,5,7,12,31,25,15
2023-24,12/15/2023,202312150DAL,Ottawa Senators,OTT,0,DAL,4,8,12,29,30,13,5,8,13,24,21,14
2023-24,12/15/2023,202312150NYI,New York Islanders,NYI,1,BOS,4,7,11,37,41,18,4,6,10,34,27,7
2023-24,12/15/2023,202312150NYR,New York Rangers,NYR,1,ANA,5,8,13,39,15,9,1,1,2,30,15,19
2023-24,12/15/2023,202312150VEG,Vegas Golden Knights,VEG,1,BUF,2,2,4,35,44,12,5,8,13,27,30,19
2023-24,12/14/2023,202312140DET,Carolina Hurricanes,CAR,0,DET,2,4,6,39,10,14,1,2,3,26,16,19
2023-24,12/14/2023,202312140EDM,Edmonton Oilers,EDM,1,TBL,4,6,10,57,26,16,7,11,18,24,24,19
2023-24,12/14/2023,202312140MIN,Calgary Flames,CGY,0,MIN,2,4,6,37,22,23,2,2,4,32,20,10
2023-24,12/14/2023,202312140PHI,Philadelphia Flyers,PHI,1,WSH,3,4,7,32,26,16,3,6,9,30,19,17
2023-24,12/14/2023,202312140SEA,Chicago Blackhawks,CHI,0,SEA,1,1,2,22,32,20,7,12,19,29,15,11
2023-24,12/14/2023,202312140STL,Ottawa Senators,OTT,0,STL,2,4,6,34,25,10,4,8,12,30,20,13
2023-24,12/14/2023,202312140TOR,Columbus Blue Jackets,CBJ,0,TOR,6,10,16,35,33,38,5,10,15,48,32,7
2023-24,12/14/2023,202312140VAN,Florida Panthers,FLA,0,VAN,0,0,0,36,31,11,4,4,8,18,35,17
2023-24,12/14/2023,202312140DET,Detroit Red Wings,DET,1,CAR,1,2,3,26,16,19,2,4,6,39,10,14
2023-24,12/14/2023,202312140EDM,Tampa Bay Lightning,TBL,0,EDM,7,11,18,24,24,19,4,6,10,57,26,16
2023-24,12/14/2023,202312140MIN,Minnesota Wild,MIN,1,CGY,2,2,4,32,20,10,2,4,6,37,22,23
2023-24,12/14/2023,202312140PHI,Washington Capitals,WSH,0,PHI,3,6,9,30,19,17,3,4,7,32,26,16
2023-24,12/14/2023,202312140SEA,Seattle Kraken,SEA,1,CHI,7,12,19,29,15,11,1,1,2,22,32,20
2023-24,12/14/2023,202312140STL,St. Louis Blues,STL,1,OTT,4,8,12,30,20,13,2,4,6,34,25,10
2023-24,12/14/2023,202312140TOR,Toronto Maple Leafs,TOR,1,CBJ,5,10,15,48,32,7,6,10,16,35,33,38
2023-24,12/14/2023,202312140VAN,Vancouver Canucks,VAN,1,FLA,4,4,8,18,35,17,0,0,0,36,31,11
2023-24,12/13/2023,202312130COL,Buffalo Sabres,BUF,0,COL,1,2,3,30,22,15,5,9,14,29,14,21
2023-24,12/13/2023,202312130LAK,Los Angeles Kings,LAK,1,WPG,2,3,5,34,24,8,5,7,12,29,29,22
2023-24,12/13/2023,202312130MTL,Montreal Canadiens,MTL,1,PIT,3,4,7,42,19,14,3,5,8,30,32,15
2023-24,12/13/2023,202312130NJD,Boston Bruins,BOS,0,NJD,1,2,3,24,20,19,2,3,5,35,25,13
2023-24,12/13/2023,202312130NYI,Anaheim Ducks,ANA,0,NYI,3,4,7,24,19,15,4,7,11,35,12,12
2023-24,12/13/2023,202312130COL,Colorado Avalanche,COL,1,BUF,5,9,14,29,14,21,1,2,3,30,22,15
2023-24,12/13/2023,202312130LAK,Winnipeg Jets,WPG,0,LAK,5,7,12,29,29,22,2,3,5,34,24,8
2023-24,12/13/2023,202312130MTL,Pittsburgh Penguins,PIT,0,MTL,3,5,8,30,32,15,3,4,7,42,19,14
2023-24,12/13/2023,202312130NJD,New Jersey Devils,NJD,1,BOS,2,3,5,35,25,13,1,2,3,24,20,19
2023-24,12/13/2023,202312130NYI,New York Islanders,NYI,1,ANA,4,7,11,35,12,12,3,4,7,24,19,15
2023-24,12/12/2023,202312120EDM,Chicago Blackhawks,CHI,0,EDM,1,2,3,23,31,22,4,7,11,29,18,11
2023-24,12/12/2023,202312120NSH,Nashville Predators,NSH,1,PHI,3,6,9,22,33,11,2,4,6,39,23,23
2023-24,12/12/2023,202312120NYR,New York Rangers,NYR,1,TOR,3,4,7,31,25,10,7,13,20,30,14,19
2023-24,12/12/2023,202312120OTT,Carolina Hurricanes,CAR,0,OTT,4,8,12,28,11,15,1,2,3,32,21,15
2023-24,12/12/2023,202312120PIT,Arizona Coyotes,ARI,0,PIT,2,4,6,21,22,16,4,7,11,43,25,18
2023-24,12/12/2023,202312120SEA,Florida Panthers,FLA,0,SEA,0,0,0,24,25,11,4,7,11,23,25,16
2023-24,12/12/2023,202312120SJS,San Jose Sharks,SJS,1,WPG,2,4,6,32,22,17,1,0,1,37,19,10
2023-24,12/12/2023,202312120STL,Detroit Red Wings,DET,0,STL,6,8,14,32,10,15,4,4,8,37,17,8
2023-24,12/12/2023,202312120VAN,Tampa Bay Lightning,TBL,0,VAN,1,2,3,29,23,12,4,7,11,22,27,17
2023-24,12/12/2023,202312120VEG,Calgary Flames,CGY,0,VEG,4,7,11,31,22,17,5,9,14,39,24,16
2023-24,12/12/2023,202312120EDM,Edmonton Oilers,EDM,1,CHI,4,7,11,29,18,11,1,2,3,23,31,22
2023-24,12/12/2023,202312120NSH,Philadelphia Flyers,PHI,0,NSH,2,4,6,39,23,23,3,6,9,22,33,11
2023-24,12/12/2023,202312120NYR,Toronto Maple Leafs,TOR,0,NYR,7,13,20,30,14,19,3,4,7,31,25,10
2023-24,12/12/2023,202312120OTT,Ottawa Senators,OTT,1,CAR,1,2,3,32,21,15,4,8,12,28,11,15
2023-24,12/12/2023,202312120PIT,Pittsburgh Penguins,PIT,1,ARI,4,7,11,43,25,18,2,4,6,21,22,16
2023-24,12/12/2023,202312120SEA,Seattle Kraken,SEA,1,FLA,4,7,11,23,25,16,0,0,0,24,25,11
2023-24,12/12/2023,202312120SJS,Winnipeg Jets,WPG,0,SJS,1,0,1,37,19,10,2,4,6,32,22,17
2023-24,12/12/2023,202312120STL,St. Louis Blues,STL,1,DET,4,4,8,37,17,8,6,8,14,32,10,15
2023-24,12/12/2023,202312120VAN,Vancouver Canucks,VAN,1,TBL,4,7,11,22,27,17,1,2,3,29,23,12
2023-24,12/12/2023,202312120VEG,Vegas Golden Knights,VEG,1,CGY,5,9,14,39,24,16,4,7,11,31,22,17
2023-24,12/11/2023,202312110BUF,Arizona Coyotes,ARI,0,BUF,2,4,6,23,27,11,5,8,13,38,21,9
2023-24,12/11/2023,202312110COL,Calgary Flames,CGY,0,COL,5,8,13,32,22,31,6,12,18,38,13,12
2023-24,12/11/2023,202312110DAL,Dallas Stars,DAL,1,DET,6,11,17,35,4,11,3,6,9,30,10,21
2023-24,12/11/2023,202312110NYI,New York Islanders,NYI,1,TOR,4,8,12,29,22,16,3,6,9,40,21,11
2023-24,12/11/2023,202312110BUF,Buffalo Sabres,BUF,1,ARI,5,8,13,38,21,9,2,4,6,23,27,11
2023-24,12/11/2023,202312110COL,Colorado Avalanche,COL,1,CGY,6,12,18,38,13,12,5,8,13,32,22,31
2023-24,12/11/2023,202312110DAL,Detroit Red Wings,DET,0,DAL,3,6,9,30,10,21,6,11,17,35,4,11
2023-24,12/11/2023,202312110NYI,Toronto Maple Leafs,TOR,0,NYI,3,6,9,40,21,11,4,8,12,29,22,16
2023-24,12/10/2023,202312100ANA,Anaheim Ducks,ANA,1,WPG,2,4,6,26,17,15,4,7,11,31,14,13
2023-24,12/10/2023,202312100CBJ,Columbus Blue Jackets,CBJ,1,FLA,2,4,6,19,21,20,5,9,14,35,11,15
2023-24,12/10/2023,202312100CHI,Chicago Blackhawks,CHI,1,WSH,2,4,6,34,18,15,4,7,11,27,19,15
2023-24,12/10/2023,202312100EDM,Edmonton Oilers,EDM,1,NJD,4,6,10,30,21,22,1,2,3,26,14,11
2023-24,12/10/2023,202312100MTL,Montreal Canadiens,MTL,1,NSH,1,0,1,37,33,15,2,4,6,32,34,12
2023-24,12/10/2023,202312100NYR,Los Angeles Kings,LAK,0,NYR,1,2,3,26,17,12,4,7,11,27,24,10
2023-24,12/10/2023,202312100SEA,Minnesota Wild,MIN,0,SEA,3,3,6,26,16,25,0,0,0,24,11,23
2023-24,12/10/2023,202312100VEG,San Jose Sharks,SJS,0,VEG,4,7,11,38,27,16,4,7,11,27,32,16
2023-24,12/10/2023,202312100ANA,Winnipeg Jets,WPG,0,ANA,4,7,11,31,14,13,2,4,6,26,17,15
2023-24,12/10/2023,202312100CBJ,Florida Panthers,FLA,0,CBJ,5,9,14,35,11,15,2,4,6,19,21,20
2023-24,12/10/2023,202312100CHI,Washington Capitals,WSH,0,CHI,4,7,11,27,19,15,2,4,6,34,18,15
2023-24,12/10/2023,202312100EDM,New Jersey Devils,NJD,0,EDM,1,2,3,26,14,11,4,6,10,30,21,22
2023-24,12/10/2023,202312100MTL,Nashville Predators,NSH,0,MTL,2,4,6,32,34,12,1,0,1,37,33,15
2023-24,12/10/2023,202312100NYR,New York Rangers,NYR,1,LAK,4,7,11,27,24,10,1,2,3,26,17,12
2023-24,12/10/2023,202312100SEA,Seattle Kraken,SEA,1,MIN,0,0,0,24,11,23,3,3,6,26,16,25
2023-24,12/10/2023,202312100VEG,Vegas Golden Knights,VEG,1,SJS,4,7,11,27,32,16,4,7,11,38,27,16
2023-24,12/9/2023,202312090BOS,Arizona Coyotes,ARI,0,BOS,3,4,7,33,20,11,5,7,12,29,25,17
2023-24,12/9/2023,202312090BUF,Buffalo Sabres,BUF,1,MTL,2,2,4,48,25,9,2,3,5,31,16,15
2023-24,12/9/2023,202312090CGY,Calgary Flames,CGY,1,NJD,2,4,6,25,14,19,4,3,7,30,22,16
2023-24,12/9/2023,202312090CHI,Chicago Blackhawks,CHI,1,STL,3,6,9,24,20,16,1,1,2,39,18,10
2023-24,12/9/2023,202312090COL,Colorado Avalanche,COL,1,PHI,2,3,5,38,22,12,5,7,12,34,23,23
2023-24,12/9/2023,202312090DAL,Dallas Stars,DAL,1,VEG,1,2,3,20,19,10,6,10,16,27,22,16
2023-24,12/9/2023,202312090DET,Detroit Red Wings,DET,1,OTT,1,1,2,31,15,18,5,7,12,37,13,15
2023-24,12/9/2023,202312090NYI,Los Angeles Kings,LAK,0,NYI,2,4,6,35,22,11,3,6,9,30,28,21
2023-24,12/9/2023,202312090SEA,Seattle Kraken,SEA,1,TBL,3,5,8,29,25,14,4,8,12,30,18,22
2023-24,12/9/2023,202312090TOR,Nashville Predators,NSH,0,TOR,0,0,0,18,36,16,4,6,10,37,31,15
2023-24,12/9/2023,202312090VAN,Carolina Hurricanes,CAR,0,VAN,3,6,9,24,13,5,4,8,12,24,27,18
2023-24,12/9/2023,202312090WSH,New York Rangers,NYR,0,WSH,0,0,0,31,21,9,4,5,9,29,19,12
2023-24,12/9/2023,202312090BOS,Boston Bruins,BOS,1,ARI,5,7,12,29,25,17,3,4,7,33,20,11
2023-24,12/9/2023,202312090BUF,Montreal Canadiens,MTL,0,BUF,2,3,5,31,16,15,2,2,4,48,25,9
2023-24,12/9/2023,202312090CGY,New Jersey Devils,NJD,0,CGY,4,3,7,30,22,16,2,4,6,25,14,19
2023-24,12/9/2023,202312090CHI,St. Louis Blues,STL,0,CHI,1,1,2,39,18,10,3,6,9,24,20,16
2023-24,12/9/2023,202312090COL,Philadelphia Flyers,PHI,0,COL,5,7,12,34,23,23,2,3,5,38,22,12
2023-24,12/9/2023,202312090DAL,Vegas Golden Knights,VEG,0,DAL,6,10,16,27,22,16,1,2,3,20,19,10
2023-24,12/9/2023,202312090DET,Ottawa Senators,OTT,0,DET,5,7,12,37,13,15,1,1,2,31,15,18
2023-24,12/9/2023,202312090NYI,New York Islanders,NYI,1,LAK,3,6,9,30,28,21,2,4,6,35,22,11
2023-24,12/9/2023,202312090SEA,Tampa Bay Lightning,TBL,0,SEA,4,8,12,30,18,22,3,5,8,29,25,14
2023-24,12/9/2023,202312090TOR,Toronto Maple Leafs,TOR,1,NSH,4,6,10,37,31,15,0,0,0,18,36,16
2023-24,12/9/2023,202312090VAN,Vancouver Canucks,VAN,1,CAR,4,8,12,24,27,18,3,6,9,24,13,5
2023-24,12/9/2023,202312090WSH,Washington Capitals,WSH,1,NYR,4,5,9,29,19,12,0,0,0,31,21,9
2023-24,12/8/2023,202312080CBJ,Columbus Blue Jackets,CBJ,1,STL,5,7,12,22,19,17,2,3,5,43,12,8
2023-24,12/8/2023,202312080EDM,Edmonton Oilers,EDM,1,MIN,4,8,12,40,17,15,3,6,9,20,24,16
2023-24,12/8/2023,202312080FLA,Florida Panthers,FLA,1,PIT,3,6,9,33,31,13,1,2,3,26,28,20
2023-24,12/8/2023,202312080CBJ,St. Louis Blues,STL,0,CBJ,2,3,5,43,12,8,5,7,12,22,19,17
2023-24,12/8/2023,202312080EDM,Minnesota Wild,MIN,0,EDM,3,6,9,20,24,16,4,8,12,40,17,15
2023-24,12/8/2023,202312080FLA,Pittsburgh Penguins,PIT,0,FLA,1,2,3,26,28,20,3,6,9,33,31,13
2023-24,12/7/2023,202312070ARI,Arizona Coyotes,ARI,1,PHI,1,2,3,26,19,9,4,7,11,26,22,23
2023-24,12/7/2023,202312070BOS,Boston Bruins,BOS,1,BUF,1,1,2,32,34,11,3,2,5,35,33,20
2023-24,12/7/2023,202312070CGY,Carolina Hurricanes,CAR,0,CGY,2,4,6,30,24,11,3,5,8,27,19,19
2023-24,12/7/2023,202312070CHI,Anaheim Ducks,ANA,0,CHI,0,0,0,37,19,7,1,2,3,25,13,20
2023-24,12/7/2023,202312070COL,Colorado Avalanche,COL,1,WPG,2,4,6,34,12,15,4,5,9,28,14,12
2023-24,12/7/2023,202312070DET,Detroit Red Wings,DET,1,SJS,5,7,12,31,19,16,6,11,17,36,15,10
2023-24,12/7/2023,202312070MTL,Los Angeles Kings,LAK,0,MTL,4,8,12,42,22,18,0,0,0,24,16,9
2023-24,12/7/2023,202312070NSH,Nashville Predators,NSH,1,TBL,5,6,11,30,22,15,1,2,3,33,19,16
2023-24,12/7/2023,202312070NYI,Columbus Blue Jackets,CBJ,0,NYI,3,5,8,35,21,14,7,11,18,36,21,22
2023-24,12/7/2023,202312070OTT,Ottawa Senators,OTT,1,TOR,3,4,7,41,18,21,4,8,12,22,30,22
2023-24,12/7/2023,202312070SEA,New Jersey Devils,NJD,0,SEA,2,4,6,17,19,16,1,2,3,38,30,11
2023-24,12/7/2023,202312070VAN,Minnesota Wild,MIN,0,VAN,0,0,0,26,17,11,2,4,6,17,26,22
2023-24,12/7/2023,202312070WSH,Dallas Stars,DAL,0,WSH,4,7,11,38,15,16,4,8,12,27,26,24
2023-24,12/7/2023,202312070ARI,Philadelphia Flyers,PHI,0,ARI,4,7,11,26,22,23,1,2,3,26,19,9
2023-24,12/7/2023,202312070BOS,Buffalo Sabres,BUF,0,BOS,3,2,5,35,33,20,1,1,2,32,34,11
2023-24,12/7/2023,202312070CGY,Calgary Flames,CGY,1,CAR,3,5,8,27,19,19,2,4,6,30,24,11
2023-24,12/7/2023,202312070CHI,Chicago Blackhawks,CHI,1,ANA,1,2,3,25,13,20,0,0,0,37,19,7
2023-24,12/7/2023,202312070COL,Winnipeg Jets,WPG,0,COL,4,5,9,28,14,12,2,4,6,34,12,15
2023-24,12/7/2023,202312070DET,San Jose Sharks,SJS,0,DET,6,11,17,36,15,10,5,7,12,31,19,16
2023-24,12/7/2023,202312070MTL,Montreal Canadiens,MTL,1,LAK,0,0,0,24,16,9,4,8,12,42,22,18
2023-24,12/7/2023,202312070NSH,Tampa Bay Lightning,TBL,0,NSH,1,2,3,33,19,16,5,6,11,30,22,15
2023-24,12/7/2023,202312070NYI,New York Islanders,NYI,1,CBJ,7,11,18,36,21,22,3,5,8,35,21,14
2023-24,12/7/2023,202312070OTT,Toronto Maple Leafs,TOR,0,OTT,4,8,12,22,30,22,3,4,7,41,18,21
2023-24,12/7/2023,202312070SEA,Seattle Kraken,SEA,1,NJD,1,2,3,38,30,11,2,4,6,17,19,16
2023-24,12/7/2023,202312070VAN,Vancouver Canucks,VAN,1,MIN,2,4,6,17,26,22,0,0,0,26,17,11
2023-24,12/7/2023,202312070WSH,Washington Capitals,WSH,1,DAL,4,8,12,27,26,24,4,7,11,38,15,16
2023-24,12/6/2023,202312060EDM,Carolina Hurricanes,CAR,0,EDM,1,1,2,39,25,7,6,10,16,34,21,17
2023-24,12/6/2023,202312060FLA,Dallas Stars,DAL,0,FLA,4,8,12,33,23,15,5,10,15,31,20,12
2023-24,12/6/2023,202312060STL,St. Louis Blues,STL,1,VEG,3,5,8,29,26,17,6,11,17,49,12,20
2023-24,12/6/2023,202312060TBL,Pittsburgh Penguins,PIT,0,TBL,1,1,2,25,21,10,3,5,8,27,15,27
2023-24,12/6/2023,202312060EDM,Edmonton Oilers,EDM,1,CAR,6,10,16,34,21,17,1,1,2,39,25,7
2023-24,12/6/2023,202312060FLA,Florida Panthers,FLA,1,DAL,5,10,15,31,20,12,4,8,12,33,23,15
2023-24,12/6/2023,202312060STL,Vegas Golden Knights,VEG,0,STL,6,11,17,49,12,20,3,5,8,29,26,17
2023-24,12/6/2023,202312060TBL,Tampa Bay Lightning,TBL,1,PIT,3,5,8,27,15,27,1,1,2,25,21,10
2023-24,12/5/2023,202312050BUF,Buffalo Sabres,BUF,1,DET,3,4,7,32,18,9,5,8,13,27,16,18
2023-24,12/5/2023,202312050CBJ,Columbus Blue Jackets,CBJ,1,LAK,3,4,7,29,17,12,4,8,12,39,15,17
2023-24,12/5/2023,202312050CGY,Calgary Flames,CGY,1,MIN,2,4,6,30,28,16,5,6,11,29,16,19
2023-24,12/5/2023,202312050CHI,Chicago Blackhawks,CHI,1,NSH,3,5,8,28,11,18,3,6,9,30,22,16
2023-24,12/5/2023,202312050COL,Anaheim Ducks,ANA,0,COL,2,2,4,33,21,15,3,5,8,30,18,18
2023-24,12/5/2023,202312050NYI,New York Islanders,NYI,1,SJS,4,7,11,39,21,20,5,7,12,37,17,17
2023-24,12/5/2023,202312050OTT,New York Rangers,NYR,0,OTT,2,4,6,35,18,19,6,11,17,36,15,9
2023-24,12/5/2023,202312050VAN,New Jersey Devils,NJD,0,VAN,6,8,14,32,27,6,5,9,14,33,33,14
2023-24,12/5/2023,202312050BUF,Detroit Red Wings,DET,0,BUF,5,8,13,27,16,18,3,4,7,32,18,9
2023-24,12/5/2023,202312050CBJ,Los Angeles Kings,LAK,0,CBJ,4,8,12,39,15,17,3,4,7,29,17,12
2023-24,12/5/2023,202312050CGY,Minnesota Wild,MIN,0,CGY,5,6,11,29,16,19,2,4,6,30,28,16
2023-24,12/5/2023,202312050CHI,Nashville Predators,NSH,0,CHI,3,6,9,30,22,16,3,5,8,28,11,18
2023-24,12/5/2023,202312050COL,Colorado Avalanche,COL,1,ANA,3,5,8,30,18,18,2,2,4,33,21,15
2023-24,12/5/2023,202312050NYI,San Jose Sharks,SJS,0,NYI,5,7,12,37,17,17,4,7,11,39,21,20
2023-24,12/5/2023,202312050OTT,Ottawa Senators,OTT,1,NYR,6,11,17,36,15,9,2,4,6,35,18,19
2023-24,12/5/2023,202312050VAN,Vancouver Canucks,VAN,1,NJD,5,9,14,33,33,14,6,8,14,32,27,6
2023-24,12/4/2023,202312040ARI,Arizona Coyotes,ARI,1,WSH,6,11,17,27,17,21,0,0,0,26,21,12
2023-24,12/4/2023,202312040MTL,Montreal Canadiens,MTL,1,SEA,4,6,10,30,16,21,2,4,6,33,26,6
2023-24,12/4/2023,202312040PHI,Philadelphia Flyers,PHI,1,PIT,2,4,6,33,26,12,1,2,3,32,9,13
2023-24,12/4/2023,202312040TBL,Dallas Stars,DAL,0,TBL,0,0,0,25,20,13,4,4,8,23,23,24
2023-24,12/4/2023,202312040VEG,St. Louis Blues,STL,0,VEG,2,4,6,27,16,17,1,2,3,34,23,23
2023-24,12/4/2023,202312040WPG,Carolina Hurricanes,CAR,0,WPG,1,2,3,43,11,10,2,4,6,22,22,18
2023-24,12/4/2023,202312040ARI,Washington Capitals,WSH,0,ARI,0,0,0,26,21,12,6,11,17,27,17,21
2023-24,12/4/2023,202312040MTL,Seattle Kraken,SEA,0,MTL,2,4,6,33,26,6,4,6,10,30,16,21
2023-24,12/4/2023,202312040PHI,Pittsburgh Penguins,PIT,0,PHI,1,2,3,32,9,13,2,4,6,33,26,12
2023-24,12/4/2023,202312040TBL,Tampa Bay Lightning,TBL,1,DAL,4,4,8,23,23,24,0,0,0,25,20,13
2023-24,12/4/2023,202312040VEG,Vegas Golden Knights,VEG,1,STL,1,2,3,34,23,23,2,4,6,27,16,17
2023-24,12/4/2023,202312040WPG,Winnipeg Jets,WPG,1,CAR,2,4,6,22,22,18,1,2,3,43,11,10
2023-24,12/3/2023,202312030BOS,Boston Bruins,BOS,1,CBJ,3,6,9,28,28,15,1,2,3,25,20,21
2023-24,12/3/2023,202312030BUF,Buffalo Sabres,BUF,1,NSH,1,0,1,35,19,14,2,2,4,29,25,12
2023-24,12/3/2023,202312030LAK,Colorado Avalanche,COL,0,LAK,1,2,3,21,16,18,4,5,9,38,13,17
2023-24,12/3/2023,202312030MIN,Chicago Blackhawks,CHI,0,MIN,1,2,3,29,31,18,4,8,12,34,21,9
2023-24,12/3/2023,202312030NYR,New York Rangers,NYR,1,SJS,6,12,18,36,22,14,5,8,13,28,23,17
2023-24,12/3/2023,202312030BOS,Columbus Blue Jackets,CBJ,0,BOS,1,2,3,25,20,21,3,6,9,28,28,15
2023-24,12/3/2023,202312030BUF,Nashville Predators,NSH,0,BUF,2,2,4,29,25,12,1,0,1,35,19,14
2023-24,12/3/2023,202312030LAK,Los Angeles Kings,LAK,1,COL,4,5,9,38,13,17,1,2,3,21,16,18
2023-24,12/3/2023,202312030MIN,Minnesota Wild,MIN,1,CHI,4,8,12,34,21,9,1,2,3,29,31,18
2023-24,12/3/2023,202312030NYR,San Jose Sharks,SJS,0,NYR,5,8,13,28,23,17,6,12,18,36,22,14
2023-24,12/2/2023,202312020ANA,Anaheim Ducks,ANA,1,COL,3,5,8,37,25,21,3,6,9,37,20,13
2023-24,12/2/2023,202312020ARI,Arizona Coyotes,ARI,1,STL,4,6,10,22,16,19,1,2,3,32,27,7
2023-24,12/2/2023,202312020CAR,Buffalo Sabres,BUF,0,CAR,2,3,5,22,24,16,6,11,17,37,14,8
2023-24,12/2/2023,202312020CGY,Calgary Flames,CGY,1,VAN,3,6,9,24,20,10,4,8,12,22,18,18
2023-24,12/2/2023,202312020DAL,Dallas Stars,DAL,1,TBL,8,15,23,34,13,10,1,1,2,33,34,9
2023-24,12/2/2023,202312020FLA,Florida Panthers,FLA,1,NYI,3,5,8,45,23,19,4,7,11,27,27,25
2023-24,12/2/2023,202312020MTL,Detroit Red Wings,DET,0,MTL,5,8,13,33,18,21,4,4,8,30,19,14
2023-24,12/2/2023,202312020NSH,Nashville Predators,NSH,1,NYR,3,5,8,40,35,16,4,8,12,25,30,19
2023-24,12/2/2023,202312020OTT,Ottawa Senators,OTT,1,SEA,2,2,4,28,18,23,0,0,0,39,18,8
2023-24,12/2/2023,202312020PIT,Philadelphia Flyers,PHI,0,PIT,3,4,7,33,39,26,3,4,7,31,24,11
2023-24,12/2/2023,202312020TOR,Boston Bruins,BOS,0,TOR,4,7,11,37,44,17,3,6,9,40,42,19
2023-24,12/2/2023,202312020VEG,Vegas Golden Knights,VEG,1,WSH,4,6,10,36,25,22,1,2,3,22,21,9
2023-24,12/2/2023,202312020WPG,Chicago Blackhawks,CHI,0,WPG,1,1,2,21,30,16,3,6,9,28,22,14
2023-24,12/2/2023,202312020ANA,Colorado Avalanche,COL,0,ANA,3,6,9,37,20,13,3,5,8,37,25,21
2023-24,12/2/2023,202312020ARI,St. Louis Blues,STL,0,ARI,1,2,3,32,27,7,4,6,10,22,16,19
2023-24,12/2/2023,202312020CAR,Carolina Hurricanes,CAR,1,BUF,6,11,17,37,14,8,2,3,5,22,24,16
2023-24,12/2/2023,202312020CGY,Vancouver Canucks,VAN,0,CGY,4,8,12,22,18,18,3,6,9,24,20,10
2023-24,12/2/2023,202312020DAL,Tampa Bay Lightning,TBL,0,DAL,1,1,2,33,34,9,8,15,23,34,13,10
2023-24,12/2/2023,202312020FLA,New York Islanders,NYI,0,FLA,4,7,11,27,27,25,3,5,8,45,23,19
2023-24,12/2/2023,202312020MTL,Montreal Canadiens,MTL,1,DET,4,4,8,30,19,14,5,8,13,33,18,21
2023-24,12/2/2023,202312020NSH,New York Rangers,NYR,0,NSH,4,8,12,25,30,19,3,5,8,40,35,16
2023-24,12/2/2023,202312020OTT,Seattle Kraken,SEA,0,OTT,0,0,0,39,18,8,2,2,4,28,18,23
2023-24,12/2/2023,202312020PIT,Pittsburgh Penguins,PIT,1,PHI,3,4,7,31,24,11,3,4,7,33,39,26
2023-24,12/2/2023,202312020TOR,Toronto Maple Leafs,TOR,1,BOS,3,6,9,40,42,19,4,7,11,37,44,17
2023-24,12/2/2023,202312020VEG,Washington Capitals,WSH,0,VEG,1,2,3,22,21,9,4,6,10,36,25,22
2023-24,12/2/2023,202312020WPG,Winnipeg Jets,WPG,1,CHI,3,6,9,28,22,14,1,1,2,21,30,16
2023-24,12/1/2023,202312010CBJ,Columbus Blue Jackets,CBJ,1,OTT,4,6,10,23,26,17,2,4,6,43,23,11
2023-24,12/1/2023,202312010NJD,New Jersey Devils,NJD,1,SJS,3,4,7,47,18,10,6,8,14,18,29,31
2023-24,12/1/2023,202312010CBJ,Ottawa Senators,OTT,0,CBJ,2,4,6,43,23,11,4,6,10,23,26,17
2023-24,12/1/2023,202312010NJD,San Jose Sharks,SJS,0,NJD,6,8,14,18,29,31,3,4,7,47,18,10
2023-24,11/30/2023,202311300ANA,Anaheim Ducks,ANA,1,WSH,4,4,8,32,15,13,5,6,11,26,14,19
2023-24,11/30/2023,202311300ARI,Arizona Coyotes,ARI,1,COL,4,6,10,33,18,17,3,6,9,31,26,15
2023-24,11/30/2023,202311300BOS,Boston Bruins,BOS,1,SJS,3,5,8,37,22,12,0,0,0,26,33,9
2023-24,11/30/2023,202311300CAR,Carolina Hurricanes,CAR,1,NYI,4,8,12,43,15,10,5,8,13,16,22,31
2023-24,11/30/2023,202311300CGY,Calgary Flames,CGY,1,DAL,4,6,10,36,15,23,3,4,7,16,18,21
2023-24,11/30/2023,202311300DET,Chicago Blackhawks,CHI,0,DET,1,2,3,35,13,6,5,9,14,29,12,15
2023-24,11/30/2023,202311300MTL,Florida Panthers,FLA,0,MTL,5,7,12,29,18,13,1,2,3,22,17,15
2023-24,11/30/2023,202311300NSH,Minnesota Wild,MIN,0,NSH,6,11,17,31,23,14,1,2,3,27,37,9
2023-24,11/30/2023,202311300PHI,New Jersey Devils,NJD,0,PHI,4,8,12,35,11,14,3,6,9,47,18,15
2023-24,11/30/2023,202311300STL,Buffalo Sabres,BUF,0,STL,4,7,11,46,6,6,6,11,17,20,16,12
2023-24,11/30/2023,202311300TBL,Pittsburgh Penguins,PIT,0,TBL,3,5,8,28,24,16,2,4,6,41,15,18
2023-24,11/30/2023,202311300TOR,Seattle Kraken,SEA,0,TOR,3,6,9,40,27,14,3,5,8,28,20,22
2023-24,11/30/2023,202311300VAN,Vancouver Canucks,VAN,1,VEG,1,2,3,22,22,9,4,8,12,44,25,14
2023-24,11/30/2023,202311300WPG,Edmonton Oilers,EDM,0,WPG,3,6,9,39,23,8,1,2,3,26,24,18
2023-24,11/30/2023,202311300ANA,Washington Capitals,WSH,0,ANA,5,6,11,26,14,19,4,4,8,32,15,13
2023-24,11/30/2023,202311300ARI,Colorado Avalanche,COL,0,ARI,3,6,9,31,26,15,4,6,10,33,18,17
2023-24,11/30/2023,202311300BOS,San Jose Sharks,SJS,0,BOS,0,0,0,26,33,9,3,5,8,37,22,12
2023-24,11/30/2023,202311300CAR,New York Islanders,NYI,0,CAR,5,8,13,16,22,31,4,8,12,43,15,10
2023-24,11/30/2023,202311300CGY,Dallas Stars,DAL,0,CGY,3,4,7,16,18,21,4,6,10,36,15,23
2023-24,11/30/2023,202311300DET,Detroit Red Wings,DET,1,CHI,5,9,14,29,12,15,1,2,3,35,13,6
2023-24,11/30/2023,202311300MTL,Montreal Canadiens,MTL,1,FLA,1,2,3,22,17,15,5,7,12,29,18,13
2023-24,11/30/2023,202311300NSH,Nashville Predators,NSH,1,MIN,1,2,3,27,37,9,6,11,17,31,23,14
2023-24,11/30/2023,202311300PHI,Philadelphia Flyers,PHI,1,NJD,3,6,9,47,18,15,4,8,12,35,11,14
2023-24,11/30/2023,202311300STL,St. Louis Blues,STL,1,BUF,6,11,17,20,16,12,4,7,11,46,6,6
2023-24,11/30/2023,202311300TBL,Tampa Bay Lightning,TBL,1,PIT,2,4,6,41,15,18,3,5,8,28,24,16
2023-24,11/30/2023,202311300TOR,Toronto Maple Leafs,TOR,1,SEA,3,5,8,28,20,22,3,6,9,40,27,14
2023-24,11/30/2023,202311300VAN,Vegas Golden Knights,VEG,0,VAN,4,8,12,44,25,14,1,2,3,22,22,9
2023-24,11/30/2023,202311300WPG,Winnipeg Jets,WPG,1,EDM,1,2,3,26,24,18,3,6,9,39,23,8
2023-24,11/29/2023,202311290CBJ,Columbus Blue Jackets,CBJ,1,MTL,2,2,4,28,25,18,4,7,11,31,21,12
2023-24,11/29/2023,202311290LAK,Los Angeles Kings,LAK,1,WSH,1,2,3,39,20,10,2,4,6,15,26,18
2023-24,11/29/2023,202311290NYR,Detroit Red Wings,DET,0,NYR,2,4,6,27,8,25,3,6,9,41,18,15
2023-24,11/29/2023,202311290CBJ,Montreal Canadiens,MTL,0,CBJ,4,7,11,31,21,12,2,2,4,28,25,18
2023-24,11/29/2023,202311290LAK,Washington Capitals,WSH,0,LAK,2,4,6,15,26,18,1,2,3,39,20,10
2023-24,11/29/2023,202311290NYR,New York Rangers,NYR,1,DET,3,6,9,41,18,15,2,4,6,27,8,25
2023-24,11/28/2023,202311280ARI,Arizona Coyotes,ARI,1,TBL,3,5,8,27,18,24,1,2,3,31,22,9
2023-24,11/28/2023,202311280CHI,Chicago Blackhawks,CHI,1,SEA,4,7,11,23,15,23,3,3,6,36,14,13
2023-24,11/28/2023,202311280EDM,Edmonton Oilers,EDM,1,VEG,4,6,10,34,31,21,4,7,11,27,31,21
2023-24,11/28/2023,202311280MIN,Minnesota Wild,MIN,1,STL,3,5,8,37,16,25,1,2,3,24,14,13
2023-24,11/28/2023,202311280NJD,New Jersey Devils,NJD,1,NYI,5,9,14,33,25,5,4,8,12,26,25,22
2023-24,11/28/2023,202311280NSH,Nashville Predators,NSH,1,PIT,3,6,9,25,33,8,2,3,5,31,16,16
2023-24,11/28/2023,202311280PHI,Carolina Hurricanes,CAR,0,PHI,4,6,10,36,9,15,1,1,2,29,11,25
2023-24,11/28/2023,202311280TOR,Florida Panthers,FLA,0,TOR,1,2,3,39,46,13,1,0,1,32,44,25
2023-24,11/28/2023,202311280VAN,Anaheim Ducks,ANA,0,VAN,1,2,3,31,35,13,3,5,8,27,27,12
2023-24,11/28/2023,202311280WPG,Dallas Stars,DAL,0,WPG,2,4,6,21,16,15,0,0,0,27,22,17
2023-24,11/28/2023,202311280ARI,Tampa Bay Lightning,TBL,0,ARI,1,2,3,31,22,9,3,5,8,27,18,24
2023-24,11/28/2023,202311280CHI,Seattle Kraken,SEA,0,CHI,3,3,6,36,14,13,4,7,11,23,15,23
2023-24,11/28/2023,202311280EDM,Vegas Golden Knights,VEG,0,EDM,4,7,11,27,31,21,4,6,10,34,31,21
2023-24,11/28/2023,202311280MIN,St. Louis Blues,STL,0,MIN,1,2,3,24,14,13,3,5,8,37,16,25
2023-24,11/28/2023,202311280NJD,New York Islanders,NYI,0,NJD,4,8,12,26,25,22,5,9,14,33,25,5
2023-24,11/28/2023,202311280NSH,Pittsburgh Penguins,PIT,0,NSH,2,3,5,31,16,16,3,6,9,25,33,8
2023-24,11/28/2023,202311280PHI,Philadelphia Flyers,PHI,1,CAR,1,1,2,29,11,25,4,6,10,36,9,15
2023-24,11/28/2023,202311280TOR,Toronto Maple Leafs,TOR,1,FLA,1,0,1,32,44,25,1,2,3,39,46,13
2023-24,11/28/2023,202311280VAN,Vancouver Canucks,VAN,1,ANA,3,5,8,27,27,12,1,2,3,31,35,13
2023-24,11/28/2023,202311280WPG,Winnipeg Jets,WPG,1,DAL,0,0,0,27,22,17,2,4,6,21,16,15
2023-24,11/27/2023,202311270CBJ,Boston Bruins,BOS,0,CBJ,2,4,6,33,14,20,5,7,12,40,18,11
2023-24,11/27/2023,202311270CGY,Calgary Flames,CGY,1,VEG,2,2,4,34,30,10,1,2,3,28,21,26
2023-24,11/27/2023,202311270COL,Colorado Avalanche,COL,1,TBL,4,5,9,23,21,18,1,2,3,39,14,12
2023-24,11/27/2023,202311270NYR,Buffalo Sabres,BUF,0,NYR,5,9,14,39,15,18,1,2,3,26,23,16
2023-24,11/27/2023,202311270OTT,Florida Panthers,FLA,0,OTT,5,7,12,37,28,12,0,0,0,20,32,17
2023-24,11/27/2023,202311270SJS,San Jose Sharks,SJS,1,WSH,2,4,6,23,22,13,1,2,3,34,22,13
2023-24,11/27/2023,202311270CBJ,Columbus Blue Jackets,CBJ,1,BOS,5,7,12,40,18,11,2,4,6,33,14,20
2023-24,11/27/2023,202311270CGY,Vegas Golden Knights,VEG,0,CGY,1,2,3,28,21,26,2,2,4,34,30,10
2023-24,11/27/2023,202311270COL,Tampa Bay Lightning,TBL,0,COL,1,2,3,39,14,12,4,5,9,23,21,18
2023-24,11/27/2023,202311270NYR,New York Rangers,NYR,1,BUF,1,2,3,26,23,16,5,9,14,39,15,18
2023-24,11/27/2023,202311270OTT,Ottawa Senators,OTT,1,FLA,0,0,0,20,32,17,5,7,12,37,28,12
2023-24,11/27/2023,202311270SJS,Washington Capitals,WSH,0,SJS,1,2,3,34,22,13,2,4,6,23,22,13
2023-24,11/26/2023,202311260CAR,Carolina Hurricanes,CAR,1,CBJ,3,6,9,43,13,11,2,1,3,23,25,28
2023-24,11/26/2023,202311260CHI,Chicago Blackhawks,CHI,1,STL,2,4,6,33,18,4,4,8,12,28,24,21
2023-24,11/26/2023,202311260DET,Detroit Red Wings,DET,1,MIN,4,7,11,23,13,13,1,2,3,38,13,21
2023-24,11/26/2023,202311260EDM,Anaheim Ducks,ANA,0,EDM,2,4,6,23,40,15,8,15,23,26,28,15
2023-24,11/26/2023,202311260NSH,Nashville Predators,NSH,1,WPG,3,5,8,26,29,13,2,2,4,34,36,11
2023-24,11/26/2023,202311260CAR,Columbus Blue Jackets,CBJ,0,CAR,2,1,3,23,25,28,3,6,9,43,13,11
2023-24,11/26/2023,202311260CHI,St. Louis Blues,STL,0,CHI,4,8,12,28,24,21,2,4,6,33,18,4
2023-24,11/26/2023,202311260DET,Minnesota Wild,MIN,0,DET,1,2,3,38,13,21,4,7,11,23,13,13
2023-24,11/26/2023,202311260EDM,Edmonton Oilers,EDM,1,ANA,8,15,23,26,28,15,2,4,6,23,40,15
2023-24,11/26/2023,202311260NSH,Winnipeg Jets,WPG,0,NSH,2,2,4,34,36,11,3,5,8,26,29,13
2023-24,11/25/2023,202311250COL,Calgary Flames,CGY,0,COL,1,2,3,30,20,13,3,4,7,24,16,19
2023-24,11/25/2023,202311250LAK,Los Angeles Kings,LAK,1,MTL,4,6,10,30,19,15,0,0,0,18,27,17
2023-24,11/25/2023,202311250NJD,Buffalo Sabres,BUF,0,NJD,2,4,6,12,16,19,7,12,19,37,42,9
2023-24,11/25/2023,202311250NYI,New York Islanders,NYI,1,PHI,0,0,0,25,24,23,0,0,0,40,27,26
2023-24,11/25/2023,202311250NYR,Boston Bruins,BOS,0,NYR,4,7,11,31,18,13,7,11,18,40,26,17
2023-24,11/25/2023,202311250PIT,Pittsburgh Penguins,PIT,1,TOR,3,4,7,35,16,21,2,3,5,33,11,21
2023-24,11/25/2023,202311250SJS,San Jose Sharks,SJS,1,VAN,4,7,11,22,16,24,3,6,9,33,20,15
2023-24,11/25/2023,202311250VEG,Arizona Coyotes,ARI,0,VEG,2,4,6,18,19,17,0,0,0,34,19,15
2023-24,11/25/2023,202311250COL,Colorado Avalanche,COL,1,CGY,3,4,7,24,16,19,1,2,3,30,20,13
2023-24,11/25/2023,202311250LAK,Montreal Canadiens,MTL,0,LAK,0,0,0,18,27,17,4,6,10,30,19,15
2023-24,11/25/2023,202311250NJD,New Jersey Devils,NJD,1,BUF,7,12,19,37,42,9,2,4,6,12,16,19
2023-24,11/25/2023,202311250NYI,Philadelphia Flyers,PHI,0,NYI,0,0,0,40,27,26,0,0,0,25,24,23
2023-24,11/25/2023,202311250NYR,New York Rangers,NYR,1,BOS,7,11,18,40,26,17,4,7,11,31,18,13
2023-24,11/25/2023,202311250PIT,Toronto Maple Leafs,TOR,0,PIT,2,3,5,33,11,21,3,4,7,35,16,21
2023-24,11/25/2023,202311250SJS,Vancouver Canucks,VAN,0,SJS,3,6,9,33,20,15,4,7,11,22,16,24
2023-24,11/25/2023,202311250VEG,Vegas Golden Knights,VEG,1,ARI,0,0,0,34,19,15,2,4,6,18,19,17
2023-24,11/24/2023,202311240ANA,Anaheim Ducks,ANA,1,LAK,2,4,6,31,25,11,5,10,15,31,26,12
2023-24,11/24/2023,202311240BOS,Boston Bruins,BOS,1,DET,2,4,6,27,22,8,5,6,11,28,14,13
2023-24,11/24/2023,202311240BUF,Buffalo Sabres,BUF,1,PIT,3,6,9,34,21,12,2,2,4,33,24,12
2023-24,11/24/2023,202311240CAR,Carolina Hurricanes,CAR,1,TBL,2,3,5,24,10,6,8,14,22,14,22,18
2023-24,11/24/2023,202311240CHI,Chicago Blackhawks,CHI,1,TOR,4,3,7,34,22,19,3,6,9,37,17,20
2023-24,11/24/2023,202311240DAL,Calgary Flames,CGY,0,DAL,7,13,20,27,25,9,4,7,11,28,13,19
2023-24,11/24/2023,202311240FLA,Florida Panthers,FLA,1,WPG,0,0,0,33,19,9,3,6,9,31,13,23
2023-24,11/24/2023,202311240MIN,Colorado Avalanche,COL,0,MIN,3,6,9,25,13,9,2,3,5,21,11,18
2023-24,11/24/2023,202311240NJD,Columbus Blue Jackets,CBJ,0,NJD,2,3,5,28,23,22,1,1,2,38,29,16
2023-24,11/24/2023,202311240OTT,New York Islanders,NYI,0,OTT,5,9,14,26,31,31,3,5,8,31,28,17
2023-24,11/24/2023,202311240PHI,New York Rangers,NYR,0,PHI,3,4,7,18,15,14,1,2,3,37,24,13
2023-24,11/24/2023,202311240SEA,Seattle Kraken,SEA,1,VAN,1,1,2,24,24,13,5,7,12,27,23,21
2023-24,11/24/2023,202311240SJS,Montreal Canadiens,MTL,0,SJS,2,3,5,24,13,15,2,4,6,33,23,19
2023-24,11/24/2023,202311240STL,Nashville Predators,NSH,0,STL,8,13,21,35,11,17,3,6,9,39,20,8
2023-24,11/24/2023,202311240WSH,Edmonton Oilers,EDM,0,WSH,5,10,15,35,17,9,0,0,0,25,26,13
2023-24,11/24/2023,202311240ANA,Los Angeles Kings,LAK,0,ANA,5,10,15,31,26,12,2,4,6,31,25,11
2023-24,11/24/2023,202311240BOS,Detroit Red Wings,DET,0,BOS,5,6,11,28,14,13,2,4,6,27,22,8
2023-24,11/24/2023,202311240BUF,Pittsburgh Penguins,PIT,0,BUF,2,2,4,33,24,12,3,6,9,34,21,12
2023-24,11/24/2023,202311240CAR,Tampa Bay Lightning,TBL,0,CAR,8,14,22,14,22,18,2,3,5,24,10,6
2023-24,11/24/2023,202311240CHI,Toronto Maple Leafs,TOR,0,CHI,3,6,9,37,17,20,4,3,7,34,22,19
2023-24,11/24/2023,202311240DAL,Dallas Stars,DAL,1,CGY,4,7,11,28,13,19,7,13,20,27,25,9
2023-24,11/24/2023,202311240FLA,Winnipeg Jets,WPG,0,FLA,3,6,9,31,13,23,0,0,0,33,19,9
2023-24,11/24/2023,202311240MIN,Minnesota Wild,MIN,1,COL,2,3,5,21,11,18,3,6,9,25,13,9
2023-24,11/24/2023,202311240NJD,New Jersey Devils,NJD,1,CBJ,1,1,2,38,29,16,2,3,5,28,23,22
2023-24,11/24/2023,202311240OTT,Ottawa Senators,OTT,1,NYI,3,5,8,31,28,17,5,9,14,26,31,31
2023-24,11/24/2023,202311240PHI,Philadelphia Flyers,PHI,1,NYR,1,2,3,37,24,13,3,4,7,18,15,14
2023-24,11/24/2023,202311240SEA,Vancouver Canucks,VAN,0,SEA,5,7,12,27,23,21,1,1,2,24,24,13
2023-24,11/24/2023,202311240SJS,San Jose Sharks,SJS,1,MTL,2,4,6,33,23,19,2,3,5,24,13,15
2023-24,11/24/2023,202311240STL,St. Louis Blues,STL,1,NSH,3,6,9,39,20,8,8,13,21,35,11,17
2023-24,11/24/2023,202311240WSH,Washington Capitals,WSH,1,EDM,0,0,0,25,26,13,5,10,15,35,17,9
2023-24,11/22/2023,202311220ANA,Anaheim Ducks,ANA,1,MTL,3,6,9,33,33,14,4,7,11,28,22,15
2023-24,11/22/2023,202311220ARI,Arizona Coyotes,ARI,1,STL,5,8,13,25,14,13,6,7,13,31,17,15
2023-24,11/22/2023,202311220CAR,Carolina Hurricanes,CAR,1,EDM,6,12,18,27,16,18,3,6,9,23,12,19
2023-24,11/22/2023,202311220CBJ,Columbus Blue Jackets,CBJ,1,CHI,7,12,19,26,11,18,3,3,6,36,22,11
2023-24,11/22/2023,202311220COL,Colorado Avalanche,COL,1,VAN,5,8,13,25,13,13,2,4,6,29,12,23
2023-24,11/22/2023,202311220DAL,Dallas Stars,DAL,1,VEG,1,2,3,32,21,9,2,3,5,26,27,19
2023-24,11/22/2023,202311220DET,Detroit Red Wings,DET,1,NJD,4,7,11,28,18,20,0,0,0,16,29,8
2023-24,11/22/2023,202311220FLA,Boston Bruins,BOS,0,FLA,3,5,8,25,20,23,1,2,3,28,30,13
2023-24,11/22/2023,202311220NSH,Calgary Flames,CGY,0,NSH,2,2,4,26,22,14,4,6,10,45,15,13
2023-24,11/22/2023,202311220NYI,New York Islanders,NYI,1,PHI,3,5,8,25,18,26,2,3,5,36,24,14
2023-24,11/22/2023,202311220PIT,New York Rangers,NYR,0,PIT,1,1,2,36,22,25,0,0,0,32,14,14
2023-24,11/22/2023,202311220SEA,Seattle Kraken,SEA,1,SJS,7,13,20,30,14,12,1,2,3,14,41,24
2023-24,11/22/2023,202311220TBL,Tampa Bay Lightning,TBL,1,WPG,2,3,5,33,28,10,3,6,9,32,27,22
2023-24,11/22/2023,202311220WSH,Buffalo Sabres,BUF,0,WSH,3,5,8,27,13,12,4,6,10,30,22,20
2023-24,11/22/2023,202311220ANA,Montreal Canadiens,MTL,0,ANA,4,7,11,28,22,15,3,6,9,33,33,14
2023-24,11/22/2023,202311220ARI,St. Louis Blues,STL,0,ARI,6,7,13,31,17,15,5,8,13,25,14,13
2023-24,11/22/2023,202311220CAR,Edmonton Oilers,EDM,0,CAR,3,6,9,23,12,19,6,12,18,27,16,18
2023-24,11/22/2023,202311220CBJ,Chicago Blackhawks,CHI,0,CBJ,3,3,6,36,22,11,7,12,19,26,11,18
2023-24,11/22/2023,202311220COL,Vancouver Canucks,VAN,0,COL,2,4,6,29,12,23,5,8,13,25,13,13
2023-24,11/22/2023,202311220DAL,Vegas Golden Knights,VEG,0,DAL,2,3,5,26,27,19,1,2,3,32,21,9
2023-24,11/22/2023,202311220DET,New Jersey Devils,NJD,0,DET,0,0,0,16,29,8,4,7,11,28,18,20
2023-24,11/22/2023,202311220FLA,Florida Panthers,FLA,1,BOS,1,2,3,28,30,13,3,5,8,25,20,23
2023-24,11/22/2023,202311220NSH,Nashville Predators,NSH,1,CGY,4,6,10,45,15,13,2,2,4,26,22,14
2023-24,11/22/2023,202311220NYI,Philadelphia Flyers,PHI,0,NYI,2,3,5,36,24,14,3,5,8,25,18,26
2023-24,11/22/2023,202311220PIT,Pittsburgh Penguins,PIT,1,NYR,0,0,0,32,14,14,1,1,2,36,22,25
2023-24,11/22/2023,202311220SEA,San Jose Sharks,SJS,0,SEA,1,2,3,14,41,24,7,13,20,30,14,12
2023-24,11/22/2023,202311220TBL,Winnipeg Jets,WPG,0,TBL,3,6,9,32,27,22,2,3,5,33,28,10
2023-24,11/22/2023,202311220WSH,Washington Capitals,WSH,1,BUF,4,6,10,30,22,20,3,5,8,27,13,12
2023-24,11/20/2023,202311200ARI,Arizona Coyotes,ARI,1,LAK,1,2,3,31,24,11,4,4,8,25,20,15
2023-24,11/20/2023,202311200DAL,Dallas Stars,DAL,1,NYR,6,8,14,36,16,11,3,6,9,33,22,21
2023-24,11/20/2023,202311200FLA,Edmonton Oilers,EDM,0,FLA,3,4,7,29,22,15,5,6,11,33,30,16
2023-24,11/20/2023,202311200NSH,Colorado Avalanche,COL,0,NSH,3,6,9,29,26,23,4,7,11,30,31,10
2023-24,11/20/2023,202311200SEA,Calgary Flames,CGY,0,SEA,4,8,12,31,23,20,3,4,7,31,26,11
2023-24,11/20/2023,202311200TBL,Boston Bruins,BOS,0,TBL,4,6,10,27,21,23,5,9,14,47,33,10
2023-24,11/20/2023,202311200VAN,San Jose Sharks,SJS,0,VAN,1,2,3,28,24,18,3,5,8,37,21,16
2023-24,11/20/2023,202311200ARI,Los Angeles Kings,LAK,0,ARI,4,4,8,25,20,15,1,2,3,31,24,11
2023-24,11/20/2023,202311200DAL,New York Rangers,NYR,0,DAL,3,6,9,33,22,21,6,8,14,36,16,11
2023-24,11/20/2023,202311200FLA,Florida Panthers,FLA,1,EDM,5,6,11,33,30,16,3,4,7,29,22,15
2023-24,11/20/2023,202311200NSH,Nashville Predators,NSH,1,COL,4,7,11,30,31,10,3,6,9,29,26,23
2023-24,11/20/2023,202311200SEA,Seattle Kraken,SEA,1,CGY,3,4,7,31,26,11,4,8,12,31,23,20
2023-24,11/20/2023,202311200TBL,Tampa Bay Lightning,TBL,1,BOS,5,9,14,47,33,10,4,6,10,27,21,23
2023-24,11/20/2023,202311200VAN,Vancouver Canucks,VAN,1,SJS,3,5,8,37,21,16,1,2,3,28,24,18
2023-24,11/19/2023,202311190ANA,Anaheim Ducks,ANA,1,STL,1,2,3,31,16,10,3,5,8,32,8,13
2023-24,11/19/2023,202311190CHI,Buffalo Sabres,BUF,0,CHI,3,6,9,20,17,13,2,4,6,26,14,9
2023-24,11/19/2023,202311190MIN,Minnesota Wild,MIN,1,TOR,3,6,9,36,22,18,4,7,11,25,14,16
2023-24,11/19/2023,202311190PHI,Columbus Blue Jackets,CBJ,0,PHI,2,3,5,22,25,14,5,8,13,27,14,18
2023-24,11/19/2023,202311190PIT,Pittsburgh Penguins,PIT,1,VEG,3,5,8,32,19,17,0,0,0,38,20,21
2023-24,11/19/2023,202311190ANA,St. Louis Blues,STL,0,ANA,3,5,8,32,8,13,1,2,3,31,16,10
2023-24,11/19/2023,202311190CHI,Chicago Blackhawks,CHI,1,BUF,2,4,6,26,14,9,3,6,9,20,17,13
2023-24,11/19/2023,202311190MIN,Toronto Maple Leafs,TOR,0,MIN,4,7,11,25,14,16,3,6,9,36,22,18
2023-24,11/19/2023,202311190PHI,Philadelphia Flyers,PHI,1,CBJ,5,8,13,27,14,18,2,3,5,22,25,14
2023-24,11/19/2023,202311190PIT,Vegas Golden Knights,VEG,0,PIT,0,0,0,38,20,21,3,5,8,32,19,17
2023-24,11/18/2023,202311180BOS,Boston Bruins,BOS,1,MTL,5,10,15,44,30,12,2,4,6,22,27,12
2023-24,11/18/2023,202311180CAR,Carolina Hurricanes,CAR,1,PIT,4,8,12,34,18,14,2,4,6,28,9,12
2023-24,11/18/2023,202311180CGY,Calgary Flames,CGY,1,NYI,4,8,12,39,25,17,4,6,10,33,24,22
2023-24,11/18/2023,202311180DAL,Colorado Avalanche,COL,0,DAL,6,9,15,38,27,13,3,6,9,28,19,14
2023-24,11/18/2023,202311180LAK,Los Angeles Kings,LAK,1,STL,5,6,11,31,16,22,1,2,3,30,27,15
2023-24,11/18/2023,202311180NJD,New Jersey Devils,NJD,1,NYR,3,6,9,33,33,16,5,7,12,35,28,19
2023-24,11/18/2023,202311180NSH,Chicago Blackhawks,CHI,0,NSH,2,3,5,31,31,9,4,7,11,31,30,14
2023-24,11/18/2023,202311180OTT,Minnesota Wild,MIN,0,OTT,1,2,3,25,24,22,1,1,2,31,10,17
2023-24,11/18/2023,202311180PHI,Philadelphia Flyers,PHI,1,VEG,4,6,10,38,26,26,3,5,8,31,21,26
2023-24,11/18/2023,202311180TBL,Edmonton Oilers,EDM,0,TBL,4,5,9,42,18,12,6,11,17,24,27,16
2023-24,11/18/2023,202311180VAN,Seattle Kraken,SEA,0,VAN,4,7,11,26,29,17,3,6,9,24,34,10
2023-24,11/18/2023,202311180WPG,Arizona Coyotes,ARI,0,WPG,2,4,6,18,19,7,5,9,14,26,22,21
2023-24,11/18/2023,202311180WSH,Columbus Blue Jackets,CBJ,0,WSH,3,5,8,36,18,16,4,7,11,26,20,19
2023-24,11/18/2023,202311180BOS,Montreal Canadiens,MTL,0,BOS,2,4,6,22,27,12,5,10,15,44,30,12
2023-24,11/18/2023,202311180CAR,Pittsburgh Penguins,PIT,0,CAR,2,4,6,28,9,12,4,8,12,34,18,14
2023-24,11/18/2023,202311180CGY,New York Islanders,NYI,0,CGY,4,6,10,33,24,22,4,8,12,39,25,17
2023-24,11/18/2023,202311180DAL,Dallas Stars,DAL,1,COL,3,6,9,28,19,14,6,9,15,38,27,13
2023-24,11/18/2023,202311180LAK,St. Louis Blues,STL,0,LAK,1,2,3,30,27,15,5,6,11,31,16,22
2023-24,11/18/2023,202311180NJD,New York Rangers,NYR,0,NJD,5,7,12,35,28,19,3,6,9,33,33,16
2023-24,11/18/2023,202311180NSH,Nashville Predators,NSH,1,CHI,4,7,11,31,30,14,2,3,5,31,31,9
2023-24,11/18/2023,202311180OTT,Ottawa Senators,OTT,1,MIN,1,1,2,31,10,17,1,2,3,25,24,22
2023-24,11/18/2023,202311180PHI,Vegas Golden Knights,VEG,0,PHI,3,5,8,31,21,26,4,6,10,38,26,26
2023-24,11/18/2023,202311180TBL,Tampa Bay Lightning,TBL,1,EDM,6,11,17,24,27,16,4,5,9,42,18,12
2023-24,11/18/2023,202311180VAN,Vancouver Canucks,VAN,1,SEA,3,6,9,24,34,10,4,7,11,26,29,17
2023-24,11/18/2023,202311180WPG,Winnipeg Jets,WPG,1,ARI,5,9,14,26,22,21,2,4,6,18,19,7
2023-24,11/18/2023,202311180WSH,Washington Capitals,WSH,1,CBJ,4,7,11,26,20,19,3,5,8,36,18,16
2023-24,11/17/2023,202311170ANA,Anaheim Ducks,ANA,1,FLA,1,2,3,35,24,29,2,3,5,35,22,12
2023-24,11/17/2023,202311170DET,Detroit Red Wings,DET,1,TOR,2,2,4,29,22,17,3,6,9,29,12,20
2023-24,11/17/2023,202311170WPG,Buffalo Sabres,BUF,0,WPG,2,2,4,28,23,12,3,6,9,18,26,17
2023-24,11/17/2023,202311170ANA,Florida Panthers,FLA,0,ANA,2,3,5,35,22,12,1,2,3,35,24,29
2023-24,11/17/2023,202311170DET,Toronto Maple Leafs,TOR,0,DET,3,6,9,29,12,20,2,2,4,29,22,17
2023-24,11/17/2023,202311170WPG,Winnipeg Jets,WPG,1,BUF,3,6,9,18,26,17,2,2,4,28,23,12
2023-24,11/16/2023,202311160CBJ,Arizona Coyotes,ARI,0,CBJ,3,5,8,32,10,27,2,4,6,41,17,12
2023-24,11/16/2023,202311160CGY,Calgary Flames,CGY,1,VAN,5,9,14,39,23,15,2,4,6,22,26,22
2023-24,11/16/2023,202311160CHI,Chicago Blackhawks,CHI,1,TBL,2,4,6,14,25,10,4,7,11,32,28,14
2023-24,11/16/2023,202311160LAK,Florida Panthers,FLA,0,LAK,1,2,3,31,33,18,2,4,6,27,24,22
2023-24,11/16/2023,202311160MTL,Montreal Canadiens,MTL,1,VEG,5,8,13,28,23,26,6,11,17,42,29,13
2023-24,11/16/2023,202311160OTT,Detroit Red Wings,DET,0,OTT,4,6,10,41,37,9,5,10,15,34,20,14
2023-24,11/16/2023,202311160PIT,New Jersey Devils,NJD,0,PIT,5,9,14,31,21,10,2,3,5,23,22,11
2023-24,11/16/2023,202311160SEA,New York Islanders,NYI,0,SEA,3,6,9,23,15,11,3,6,9,32,15,21
2023-24,11/16/2023,202311160SJS,San Jose Sharks,SJS,1,STL,5,9,14,35,14,21,1,2,3,45,9,7
2023-24,11/16/2023,202311160CBJ,Columbus Blue Jackets,CBJ,1,ARI,2,4,6,41,17,12,3,5,8,32,10,27
2023-24,11/16/2023,202311160CGY,Vancouver Canucks,VAN,0,CGY,2,4,6,22,26,22,5,9,14,39,23,15
2023-24,11/16/2023,202311160CHI,Tampa Bay Lightning,TBL,0,CHI,4,7,11,32,28,14,2,4,6,14,25,10
2023-24,11/16/2023,202311160LAK,Los Angeles Kings,LAK,1,FLA,2,4,6,27,24,22,1,2,3,31,33,18
2023-24,11/16/2023,202311160MTL,Vegas Golden Knights,VEG,0,MTL,6,11,17,42,29,13,5,8,13,28,23,26
2023-24,11/16/2023,202311160OTT,Ottawa Senators,OTT,1,DET,5,10,15,34,20,14,4,6,10,41,37,9
2023-24,11/16/2023,202311160PIT,Pittsburgh Penguins,PIT,1,NJD,2,3,5,23,22,11,5,9,14,31,21,10
2023-24,11/16/2023,202311160SEA,Seattle Kraken,SEA,1,NYI,3,6,9,32,15,21,3,6,9,23,15,11
2023-24,11/16/2023,202311160SJS,St. Louis Blues,STL,0,SJS,1,2,3,45,9,7,5,9,14,35,14,21
2023-24,11/15/2023,202311150CAR,Carolina Hurricanes,CAR,1,PHI,1,2,3,32,14,8,3,6,9,24,10,30
2023-24,11/15/2023,202311150COL,Anaheim Ducks,ANA,0,COL,2,4,6,17,28,6,8,15,23,38,17,10
2023-24,11/15/2023,202311150EDM,Edmonton Oilers,EDM,1,SEA,4,8,12,31,20,22,3,6,9,35,30,13
2023-24,11/15/2023,202311150VAN,New York Islanders,NYI,0,VAN,3,5,8,33,24,17,4,8,12,43,31,14
2023-24,11/15/2023,202311150CAR,Philadelphia Flyers,PHI,0,CAR,3,6,9,24,10,30,1,2,3,32,14,8
2023-24,11/15/2023,202311150COL,Colorado Avalanche,COL,1,ANA,8,15,23,38,17,10,2,4,6,17,28,6
2023-24,11/15/2023,202311150EDM,Seattle Kraken,SEA,0,EDM,3,6,9,35,30,13,4,8,12,31,20,22
2023-24,11/15/2023,202311150VAN,Vancouver Canucks,VAN,1,NYI,4,8,12,43,31,14,3,5,8,33,24,17
2023-24,11/14/2023,202311140BUF,Boston Bruins,BOS,0,BUF,5,9,14,32,17,10,2,4,6,34,18,16
2023-24,11/14/2023,202311140CBJ,Columbus Blue Jackets,CBJ,1,PIT,3,4,7,30,18,22,5,9,14,40,10,9
2023-24,11/14/2023,202311140DAL,Arizona Coyotes,ARI,0,DAL,3,4,7,26,19,23,4,7,11,36,15,8
2023-24,11/14/2023,202311140MTL,Calgary Flames,CGY,0,MTL,2,4,6,29,13,20,1,2,3,35,18,9
2023-24,11/14/2023,202311140NSH,Anaheim Ducks,ANA,0,NSH,3,6,9,20,25,20,2,4,6,30,13,10
2023-24,11/14/2023,202311140SJS,Florida Panthers,FLA,0,SJS,5,8,13,31,16,5,3,6,9,22,19,22
2023-24,11/14/2023,202311140STL,St. Louis Blues,STL,1,TBL,5,8,13,29,19,26,0,0,0,30,17,12
2023-24,11/14/2023,202311140WPG,New Jersey Devils,NJD,0,WPG,3,6,9,34,24,10,6,12,18,31,16,21
2023-24,11/14/2023,202311140WSH,Vegas Golden Knights,VEG,0,WSH,0,0,0,35,11,7,3,3,6,31,23,17
2023-24,11/14/2023,202311140BUF,Buffalo Sabres,BUF,1,BOS,2,4,6,34,18,16,5,9,14,32,17,10
2023-24,11/14/2023,202311140CBJ,Pittsburgh Penguins,PIT,0,CBJ,5,9,14,40,10,9,3,4,7,30,18,22
2023-24,11/14/2023,202311140DAL,Dallas Stars,DAL,1,ARI,4,7,11,36,15,8,3,4,7,26,19,23
2023-24,11/14/2023,202311140MTL,Montreal Canadiens,MTL,1,CGY,1,2,3,35,18,9,2,4,6,29,13,20
2023-24,11/14/2023,202311140NSH,Nashville Predators,NSH,1,ANA,2,4,6,30,13,10,3,6,9,20,25,20
2023-24,11/14/2023,202311140SJS,San Jose Sharks,SJS,1,FLA,3,6,9,22,19,22,5,8,13,31,16,5
2023-24,11/14/2023,202311140STL,Tampa Bay Lightning,TBL,0,STL,0,0,0,30,17,12,5,8,13,29,19,26
2023-24,11/14/2023,202311140WPG,Winnipeg Jets,WPG,1,NJD,6,12,18,31,16,21,3,6,9,34,24,10
2023-24,11/14/2023,202311140WSH,Washington Capitals,WSH,1,VEG,3,3,6,31,23,17,0,0,0,35,11,7
2023-24,11/13/2023,202311130EDM,Edmonton Oilers,EDM,1,NYI,4,5,9,32,32,12,1,2,3,33,30,21
2023-24,11/13/2023,202311130SEA,Colorado Avalanche,COL,0,SEA,5,10,15,31,19,15,1,2,3,19,18,19
2023-24,11/13/2023,202311130EDM,New York Islanders,NYI,0,EDM,1,2,3,33,30,21,4,5,9,32,32,12
2023-24,11/13/2023,202311130SEA,Seattle Kraken,SEA,1,COL,1,2,3,19,18,19,5,10,15,31,19,15
2023-24,11/12/2023,202311120ANA,Anaheim Ducks,ANA,1,SJS,4,8,12,44,21,10,1,2,3,26,21,17
2023-24,11/12/2023,202311120FLA,Chicago Blackhawks,CHI,0,FLA,3,3,6,26,25,23,4,8,12,31,25,10
2023-24,11/12/2023,202311120MIN,Dallas Stars,DAL,0,MIN,8,13,21,37,8,11,3,4,7,26,19,16
2023-24,11/12/2023,202311120MTL,Montreal Canadiens,MTL,1,VAN,2,3,5,32,16,24,5,9,14,37,19,17
2023-24,11/12/2023,202311120NYR,Columbus Blue Jackets,CBJ,0,NYR,3,5,8,28,16,22,3,6,9,40,19,12
2023-24,11/12/2023,202311120ANA,San Jose Sharks,SJS,0,ANA,1,2,3,26,21,17,4,8,12,44,21,10
2023-24,11/12/2023,202311120FLA,Florida Panthers,FLA,1,CHI,4,8,12,31,25,10,3,3,6,26,25,23
2023-24,11/12/2023,202311120MIN,Minnesota Wild,MIN,1,DAL,3,4,7,26,19,16,8,13,21,37,8,11
2023-24,11/12/2023,202311120MTL,Vancouver Canucks,VAN,0,MTL,5,9,14,37,19,17,2,3,5,32,16,24
2023-24,11/12/2023,202311120NYR,New York Rangers,NYR,1,CBJ,3,6,9,40,19,12,3,5,8,28,16,22
2023-24,11/11/2023,202311110COL,Colorado Avalanche,COL,1,STL,2,3,5,38,20,12,8,13,21,42,21,18
2023-24,11/11/2023,202311110DET,Columbus Blue Jackets,CBJ,0,DET,4,5,9,22,16,15,5,7,12,28,14,24
2023-24,11/11/2023,202311110LAK,Los Angeles Kings,LAK,1,PHI,2,4,6,37,15,12,4,6,10,26,27,20
2023-24,11/11/2023,202311110MTL,Boston Bruins,BOS,0,MTL,2,4,6,28,15,17,3,4,7,27,30,18
2023-24,11/11/2023,202311110NSH,Arizona Coyotes,ARI,0,NSH,7,11,18,25,25,16,5,10,15,42,29,11
2023-24,11/11/2023,202311110NYI,New York Islanders,NYI,1,WSH,1,1,2,37,23,11,4,7,11,28,20,32
2023-24,11/11/2023,202311110OTT,Calgary Flames,CGY,0,OTT,1,1,2,25,28,11,4,8,12,38,23,19
2023-24,11/11/2023,202311110PIT,Buffalo Sabres,BUF,0,PIT,0,0,0,35,20,15,4,8,12,39,16,13
2023-24,11/11/2023,202311110SEA,Edmonton Oilers,EDM,0,SEA,4,6,10,26,13,13,1,2,3,18,22,10
2023-24,11/11/2023,202311110TBL,Carolina Hurricanes,CAR,0,TBL,4,7,11,32,15,14,0,0,0,22,24,11
2023-24,11/11/2023,202311110TOR,Toronto Maple Leafs,TOR,1,VAN,5,9,14,22,27,17,2,4,6,33,28,12
2023-24,11/11/2023,202311110WPG,Dallas Stars,DAL,0,WPG,3,3,6,29,10,17,2,4,6,33,14,16
2023-24,11/11/2023,202311110COL,St. Louis Blues,STL,0,COL,8,13,21,42,21,18,2,3,5,38,20,12
2023-24,11/11/2023,202311110DET,Detroit Red Wings,DET,1,CBJ,5,7,12,28,14,24,4,5,9,22,16,15
2023-24,11/11/2023,202311110LAK,Philadelphia Flyers,PHI,0,LAK,4,6,10,26,27,20,2,4,6,37,15,12
2023-24,11/11/2023,202311110MTL,Montreal Canadiens,MTL,1,BOS,3,4,7,27,30,18,2,4,6,28,15,17
2023-24,11/11/2023,202311110NSH,Nashville Predators,NSH,1,ARI,5,10,15,42,29,11,7,11,18,25,25,16
2023-24,11/11/2023,202311110NYI,Washington Capitals,WSH,0,NYI,4,7,11,28,20,32,1,1,2,37,23,11
2023-24,11/11/2023,202311110OTT,Ottawa Senators,OTT,1,CGY,4,8,12,38,23,19,1,1,2,25,28,11
2023-24,11/11/2023,202311110PIT,Pittsburgh Penguins,PIT,1,BUF,4,8,12,39,16,13,0,0,0,35,20,15
2023-24,11/11/2023,202311110SEA,Seattle Kraken,SEA,1,EDM,1,2,3,18,22,10,4,6,10,26,13,13
2023-24,11/11/2023,202311110TBL,Tampa Bay Lightning,TBL,1,CAR,0,0,0,22,24,11,4,7,11,32,15,14
2023-24,11/11/2023,202311110TOR,Vancouver Canucks,VAN,0,TOR,2,4,6,33,28,12,5,9,14,22,27,17
2023-24,11/11/2023,202311110WPG,Winnipeg Jets,WPG,1,DAL,2,4,6,33,14,16,3,3,6,29,10,17
2023-24,11/10/2023,202311100ANA,Anaheim Ducks,ANA,1,PHI,3,6,9,38,18,9,6,10,16,36,13,21
2023-24,11/10/2023,202311100BUF,Buffalo Sabres,BUF,1,MIN,3,4,7,25,20,22,2,4,6,35,31,18
2023-24,11/10/2023,202311100FLA,Carolina Hurricanes,CAR,0,FLA,2,4,6,30,25,15,5,9,14,35,23,23
2023-24,11/10/2023,202311100NJD,New Jersey Devils,NJD,1,WSH,2,3,5,26,34,12,4,8,12,27,19,18
2023-24,11/10/2023,202311100TOR,Calgary Flames,CGY,0,TOR,4,7,11,28,25,19,4,4,8,36,29,15
2023-24,11/10/2023,202311100VEG,San Jose Sharks,SJS,0,VEG,0,0,0,20,29,16,5,9,14,39,17,15
2023-24,11/10/2023,202311100ANA,Philadelphia Flyers,PHI,0,ANA,6,10,16,36,13,21,3,6,9,38,18,9
2023-24,11/10/2023,202311100BUF,Minnesota Wild,MIN,0,BUF,2,4,6,35,31,18,3,4,7,25,20,22
2023-24,11/10/2023,202311100FLA,Florida Panthers,FLA,1,CAR,5,9,14,35,23,23,2,4,6,30,25,15
2023-24,11/10/2023,202311100NJD,Washington Capitals,WSH,0,NJD,4,8,12,27,19,18,2,3,5,26,34,12
2023-24,11/10/2023,202311100TOR,Toronto Maple Leafs,TOR,1,CGY,4,4,8,36,29,15,4,7,11,28,25,19
2023-24,11/10/2023,202311100VEG,Vegas Golden Knights,VEG,1,SJS,5,9,14,39,17,15,0,0,0,20,29,16
2023-24,11/9/2023,202311090BOS,Boston Bruins,BOS,1,NYI,5,10,15,35,26,19,2,3,5,29,28,15
2023-24,11/9/2023,202311090CBJ,Columbus Blue Jackets,CBJ,1,DAL,2,4,6,29,18,20,5,8,13,31,6,9
2023-24,11/9/2023,202311090COL,Colorado Avalanche,COL,1,SEA,3,6,9,26,27,13,4,8,12,22,28,22
2023-24,11/9/2023,202311090DET,Detroit Red Wings,DET,1,MTL,2,2,4,29,19,12,3,5,8,27,21,14
2023-24,11/9/2023,202311090LAK,Los Angeles Kings,LAK,1,PIT,3,6,9,36,21,13,4,4,8,20,26,16
2023-24,11/9/2023,202311090NYR,Minnesota Wild,MIN,0,NYR,1,2,3,26,21,14,4,8,12,28,32,15
2023-24,11/9/2023,202311090OTT,Ottawa Senators,OTT,1,VAN,2,2,4,30,28,19,5,10,15,16,26,15
2023-24,11/9/2023,202311090SJS,Edmonton Oilers,EDM,0,SJS,2,4,6,41,21,12,3,6,9,18,20,35
2023-24,11/9/2023,202311090STL,Arizona Coyotes,ARI,0,STL,1,2,3,20,19,14,2,4,6,33,21,12
2023-24,11/9/2023,202311090TBL,Chicago Blackhawks,CHI,0,TBL,5,9,14,29,16,20,3,6,9,33,26,6
2023-24,11/9/2023,202311090WPG,Nashville Predators,NSH,0,WPG,3,4,7,23,15,14,6,12,18,37,20,15
2023-24,11/9/2023,202311090BOS,New York Islanders,NYI,0,BOS,2,3,5,29,28,15,5,10,15,35,26,19
2023-24,11/9/2023,202311090CBJ,Dallas Stars,DAL,0,CBJ,5,8,13,31,6,9,2,4,6,29,18,20
2023-24,11/9/2023,202311090COL,Seattle Kraken,SEA,0,COL,4,8,12,22,28,22,3,6,9,26,27,13
2023-24,11/9/2023,202311090DET,Montreal Canadiens,MTL,0,DET,3,5,8,27,21,14,2,2,4,29,19,12
2023-24,11/9/2023,202311090LAK,Pittsburgh Penguins,PIT,0,LAK,4,4,8,20,26,16,3,6,9,36,21,13
2023-24,11/9/2023,202311090NYR,New York Rangers,NYR,1,MIN,4,8,12,28,32,15,1,2,3,26,21,14
2023-24,11/9/2023,202311090OTT,Vancouver Canucks,VAN,0,OTT,5,10,15,16,26,15,2,2,4,30,28,19
2023-24,11/9/2023,202311090SJS,San Jose Sharks,SJS,1,EDM,3,6,9,18,20,35,2,4,6,41,21,12
2023-24,11/9/2023,202311090STL,St. Louis Blues,STL,1,ARI,2,4,6,33,21,12,1,2,3,20,19,14
2023-24,11/9/2023,202311090TBL,Tampa Bay Lightning,TBL,1,CHI,3,6,9,33,26,6,5,9,14,29,16,20
2023-24,11/9/2023,202311090WPG,Winnipeg Jets,WPG,1,NSH,6,12,18,37,20,15,3,4,7,23,15,14
2023-24,11/8/2023,202311080TOR,Ottawa Senators,OTT,0,TOR,6,11,17,31,31,14,3,6,9,30,49,12
2023-24,11/8/2023,202311080VEG,Los Angeles Kings,LAK,0,VEG,4,7,11,33,13,17,1,2,3,38,17,28
2023-24,11/8/2023,202311080WSH,Florida Panthers,FLA,0,WSH,4,7,11,25,26,15,3,4,7,28,27,13
2023-24,11/8/2023,202311080TOR,Toronto Maple Leafs,TOR,1,OTT,3,6,9,30,49,12,6,11,17,31,31,14
2023-24,11/8/2023,202311080VEG,Vegas Golden Knights,VEG,1,LAK,1,2,3,38,17,28,4,7,11,33,13,17
2023-24,11/8/2023,202311080WSH,Washington Capitals,WSH,1,FLA,3,4,7,28,27,13,4,7,11,25,26,15
2023-24,11/7/2023,202311070ANA,Anaheim Ducks,ANA,1,PIT,0,0,0,31,23,14,2,4,6,36,11,14
2023-24,11/7/2023,202311070ARI,Arizona Coyotes,ARI,1,SEA,3,6,9,27,28,15,3,6,9,38,30,11
2023-24,11/7/2023,202311070CAR,Buffalo Sabres,BUF,0,CAR,2,2,4,21,14,20,3,4,7,27,23,7
2023-24,11/7/2023,202311070CGY,Calgary Flames,CGY,1,NSH,4,8,12,39,19,15,2,4,6,18,17,19
2023-24,11/7/2023,202311070COL,Colorado Avalanche,COL,1,NJD,6,8,14,32,22,16,3,6,9,23,13,16
2023-24,11/7/2023,202311070MTL,Montreal Canadiens,MTL,1,TBL,3,6,9,26,24,12,5,10,15,32,17,17
2023-24,11/7/2023,202311070NYI,Minnesota Wild,MIN,0,NYI,4,7,11,31,23,22,2,4,6,29,20,11
2023-24,11/7/2023,202311070NYR,Detroit Red Wings,DET,0,NYR,3,5,8,28,16,9,5,8,13,32,25,9
2023-24,11/7/2023,202311070SJS,Philadelphia Flyers,PHI,0,SJS,1,2,3,39,12,23,2,3,5,19,19,17
2023-24,11/7/2023,202311070STL,St. Louis Blues,STL,1,WPG,2,4,6,22,14,10,5,9,14,37,10,8
2023-24,11/7/2023,202311070ANA,Pittsburgh Penguins,PIT,0,ANA,2,4,6,36,11,14,0,0,0,31,23,14
2023-24,11/7/2023,202311070ARI,Seattle Kraken,SEA,0,ARI,3,6,9,38,30,11,3,6,9,27,28,15
2023-24,11/7/2023,202311070CAR,Carolina Hurricanes,CAR,1,BUF,3,4,7,27,23,7,2,2,4,21,14,20
2023-24,11/7/2023,202311070CGY,Nashville Predators,NSH,0,CGY,2,4,6,18,17,19,4,8,12,39,19,15
2023-24,11/7/2023,202311070COL,New Jersey Devils,NJD,0,COL,3,6,9,23,13,16,6,8,14,32,22,16
2023-24,11/7/2023,202311070MTL,Tampa Bay Lightning,TBL,0,MTL,5,10,15,32,17,17,3,6,9,26,24,12
2023-24,11/7/2023,202311070NYI,New York Islanders,NYI,1,MIN,2,4,6,29,20,11,4,7,11,31,23,22
2023-24,11/7/2023,202311070NYR,New York Rangers,NYR,1,DET,5,8,13,32,25,9,3,5,8,28,16,9
2023-24,11/7/2023,202311070SJS,San Jose Sharks,SJS,1,PHI,2,3,5,19,19,17,1,2,3,39,12,23
2023-24,11/7/2023,202311070STL,Winnipeg Jets,WPG,0,STL,5,9,14,37,10,8,2,4,6,22,14,10
2023-24,11/6/2023,202311060DAL,Boston Bruins,BOS,0,DAL,3,5,8,29,10,17,2,4,6,37,22,17
2023-24,11/6/2023,202311060FLA,Columbus Blue Jackets,CBJ,0,FLA,4,8,12,23,43,30,5,8,13,46,12,23
2023-24,11/6/2023,202311060TOR,Tampa Bay Lightning,TBL,0,TOR,5,10,15,31,38,12,6,12,18,34,34,14
2023-24,11/6/2023,202311060VAN,Edmonton Oilers,EDM,0,VAN,2,3,5,43,29,11,6,11,17,36,28,19
2023-24,11/6/2023,202311060DAL,Dallas Stars,DAL,1,BOS,2,4,6,37,22,17,3,5,8,29,10,17
2023-24,11/6/2023,202311060FLA,Florida Panthers,FLA,1,CBJ,5,8,13,46,12,23,4,8,12,23,43,30
2023-24,11/6/2023,202311060TOR,Toronto Maple Leafs,TOR,1,TBL,6,12,18,34,34,14,5,10,15,31,38,12
2023-24,11/6/2023,202311060VAN,Vancouver Canucks,VAN,1,EDM,6,11,17,36,28,19,2,3,5,43,29,11
2023-24,11/5/2023,202311050ANA,Anaheim Ducks,ANA,1,VEG,4,7,11,23,16,14,2,3,5,32,18,16
2023-24,11/5/2023,202311050CHI,Chicago Blackhawks,CHI,1,NJD,2,4,6,34,26,16,4,3,7,41,21,13
2023-24,11/5/2023,202311050ANA,Vegas Golden Knights,VEG,0,ANA,2,3,5,32,18,16,4,7,11,23,16,14
2023-24,11/5/2023,202311050CHI,New Jersey Devils,NJD,0,CHI,4,3,7,41,21,13,2,4,6,34,26,16
2023-24,11/4/2023,202311040ARI,Arizona Coyotes,ARI,1,WPG,3,4,7,25,11,22,5,10,15,27,16,10
2023-24,11/4/2023,202311040CHI,Chicago Blackhawks,CHI,1,FLA,5,9,14,25,23,29,2,4,6,40,23,7
2023-24,11/4/2023,202311040DET,Boston Bruins,BOS,0,DET,4,8,12,30,22,22,5,10,15,40,25,16
2023-24,11/4/2023,202311040EDM,Edmonton Oilers,EDM,1,NSH,2,4,6,35,33,6,5,10,15,34,25,16
2023-24,11/4/2023,202311040MIN,Minnesota Wild,MIN,1,NYR,4,8,12,39,20,16,4,8,12,18,20,32
2023-24,11/4/2023,202311040NYI,Carolina Hurricanes,CAR,0,NYI,4,7,11,46,22,7,3,5,8,25,21,28
2023-24,11/4/2023,202311040OTT,Ottawa Senators,OTT,1,TBL,4,7,11,28,19,16,6,9,15,38,32,16
2023-24,11/4/2023,202311040PHI,Los Angeles Kings,LAK,0,PHI,5,8,13,30,14,14,0,0,0,24,28,11
2023-24,11/4/2023,202311040SEA,Calgary Flames,CGY,0,SEA,6,8,14,31,24,16,3,6,9,20,13,10
2023-24,11/4/2023,202311040SJS,Pittsburgh Penguins,PIT,0,SJS,10,16,26,35,16,12,2,4,6,26,45,21
2023-24,11/4/2023,202311040STL,Montreal Canadiens,MTL,0,STL,3,5,8,33,15,14,6,8,14,35,25,12
2023-24,11/4/2023,202311040TOR,Buffalo Sabres,BUF,0,TOR,6,7,13,41,22,18,4,7,11,28,34,14
2023-24,11/4/2023,202311040VAN,Dallas Stars,DAL,0,VAN,0,0,0,27,17,13,2,4,6,28,24,13
2023-24,11/4/2023,202311040VEG,Colorado Avalanche,COL,0,VEG,0,0,0,41,30,10,7,11,18,34,22,26
2023-24,11/4/2023,202311040WSH,Columbus Blue Jackets,CBJ,0,WSH,1,2,3,35,14,13,2,2,4,27,25,25
2023-24,11/4/2023,202311040ARI,Winnipeg Jets,WPG,0,ARI,5,10,15,27,16,10,3,4,7,25,11,22
2023-24,11/4/2023,202311040CHI,Florida Panthers,FLA,0,CHI,2,4,6,40,23,7,5,9,14,25,23,29
2023-24,11/4/2023,202311040DET,Detroit Red Wings,DET,1,BOS,5,10,15,40,25,16,4,8,12,30,22,22
2023-24,11/4/2023,202311040EDM,Nashville Predators,NSH,0,EDM,5,10,15,34,25,16,2,4,6,35,33,6
2023-24,11/4/2023,202311040MIN,New York Rangers,NYR,0,MIN,4,8,12,18,20,32,4,8,12,39,20,16
2023-24,11/4/2023,202311040NYI,New York Islanders,NYI,1,CAR,3,5,8,25,21,28,4,7,11,46,22,7
2023-24,11/4/2023,202311040OTT,Tampa Bay Lightning,TBL,0,OTT,6,9,15,38,32,16,4,7,11,28,19,16
2023-24,11/4/2023,202311040PHI,Philadelphia Flyers,PHI,1,LAK,0,0,0,24,28,11,5,8,13,30,14,14
2023-24,11/4/2023,202311040SEA,Seattle Kraken,SEA,1,CGY,3,6,9,20,13,10,6,8,14,31,24,16
2023-24,11/4/2023,202311040SJS,San Jose Sharks,SJS,1,PIT,2,4,6,26,45,21,10,16,26,35,16,12
2023-24,11/4/2023,202311040STL,St. Louis Blues,STL,1,MTL,6,8,14,35,25,12,3,5,8,33,15,14
2023-24,11/4/2023,202311040TOR,Toronto Maple Leafs,TOR,1,BUF,4,7,11,28,34,14,6,7,13,41,22,18
2023-24,11/4/2023,202311040VAN,Vancouver Canucks,VAN,1,DAL,2,4,6,28,24,13,0,0,0,27,17,13
2023-24,11/4/2023,202311040VEG,Vegas Golden Knights,VEG,1,COL,7,11,18,34,22,26,0,0,0,41,30,10
2023-24,11/4/2023,202311040WSH,Washington Capitals,WSH,1,CBJ,2,2,4,27,25,25,1,2,3,35,14,13
2023-24,11/3/2023,202311030BUF,Buffalo Sabres,BUF,1,PHI,1,2,3,22,21,21,5,5,10,19,24,13
2023-24,11/3/2023,202311030STL,New Jersey Devils,NJD,0,STL,1,2,3,34,11,13,4,7,11,35,33,8
2023-24,11/3/2023,202311030BUF,Philadelphia Flyers,PHI,0,BUF,5,5,10,19,24,13,1,2,3,22,21,21
2023-24,11/3/2023,202311030STL,St. Louis Blues,STL,1,NJD,4,7,11,35,33,8,1,2,3,34,11,13
2023-24,11/2/2023,202311020ARI,Arizona Coyotes,ARI,1,MTL,3,4,7,35,19,10,2,3,5,30,22,25
2023-24,11/2/2023,202311020BOS,Boston Bruins,BOS,1,TOR,2,4,6,40,27,15,2,4,6,35,32,20
2023-24,11/2/2023,202311020CBJ,Columbus Blue Jackets,CBJ,1,TBL,4,8,12,28,12,22,2,2,4,29,17,17
2023-24,11/2/2023,202311020DET,Detroit Red Wings,DET,1,FLA,0,0,0,22,30,20,2,3,5,27,10,11
2023-24,11/2/2023,202311020EDM,Dallas Stars,DAL,0,EDM,4,8,12,27,21,25,3,4,7,49,24,13
2023-24,11/2/2023,202311020MIN,Minnesota Wild,MIN,1,NJD,3,6,9,25,26,12,5,9,14,38,13,11
2023-24,11/2/2023,202311020NYR,Carolina Hurricanes,CAR,0,NYR,1,2,3,27,13,10,2,3,5,26,21,20
2023-24,11/2/2023,202311020OTT,Los Angeles Kings,LAK,0,OTT,3,5,8,38,25,12,2,4,6,26,28,21
2023-24,11/2/2023,202311020SEA,Nashville Predators,NSH,0,SEA,2,4,6,34,26,20,4,7,11,31,20,13
2023-24,11/2/2023,202311020SJS,San Jose Sharks,SJS,1,VAN,1,2,3,31,20,20,10,18,28,33,12,13
2023-24,11/2/2023,202311020VEG,Vegas Golden Knights,VEG,1,WPG,5,7,12,26,31,22,2,4,6,31,23,7
2023-24,11/2/2023,202311020WSH,New York Islanders,NYI,0,WSH,3,6,9,21,27,23,0,0,0,32,14,6
2023-24,11/2/2023,202311020ARI,Montreal Canadiens,MTL,0,ARI,2,3,5,30,22,25,3,4,7,35,19,10
2023-24,11/2/2023,202311020BOS,Toronto Maple Leafs,TOR,0,BOS,2,4,6,35,32,20,2,4,6,40,27,15
2023-24,11/2/2023,202311020CBJ,Tampa Bay Lightning,TBL,0,CBJ,2,2,4,29,17,17,4,8,12,28,12,22
2023-24,11/2/2023,202311020DET,Florida Panthers,FLA,0,DET,2,3,5,27,10,11,0,0,0,22,30,20
2023-24,11/2/2023,202311020EDM,Edmonton Oilers,EDM,1,DAL,3,4,7,49,24,13,4,8,12,27,21,25
2023-24,11/2/2023,202311020MIN,New Jersey Devils,NJD,0,MIN,5,9,14,38,13,11,3,6,9,25,26,12
2023-24,11/2/2023,202311020NYR,New York Rangers,NYR,1,CAR,2,3,5,26,21,20,1,2,3,27,13,10
2023-24,11/2/2023,202311020OTT,Ottawa Senators,OTT,1,LAK,2,4,6,26,28,21,3,5,8,38,25,12
2023-24,11/2/2023,202311020SEA,Seattle Kraken,SEA,1,NSH,4,7,11,31,20,13,2,4,6,34,26,20
2023-24,11/2/2023,202311020SJS,Vancouver Canucks,VAN,0,SJS,10,18,28,33,12,13,1,2,3,31,20,20
2023-24,11/2/2023,202311020VEG,Winnipeg Jets,WPG,0,VEG,2,4,6,31,23,7,5,7,12,26,31,22
2023-24,11/2/2023,202311020WSH,Washington Capitals,WSH,1,NYI,0,0,0,32,14,6,3,6,9,21,27,23
2023-24,11/1/2023,202311010ANA,Anaheim Ducks,ANA,1,ARI,4,5,9,29,32,18,3,6,9,35,11,7
2023-24,11/1/2023,202311010CGY,Calgary Flames,CGY,1,DAL,3,6,9,47,18,13,4,8,12,30,20,18
2023-24,11/1/2023,202311010COL,Colorado Avalanche,COL,1,STL,4,6,10,28,15,10,1,2,3,28,19,14
2023-24,11/1/2023,202311010PHI,Buffalo Sabres,BUF,0,PHI,5,9,14,15,18,18,2,2,4,40,33,12
2023-24,11/1/2023,202311010ANA,Arizona Coyotes,ARI,0,ANA,3,6,9,35,11,7,4,5,9,29,32,18
2023-24,11/1/2023,202311010CGY,Dallas Stars,DAL,0,CGY,4,8,12,30,20,18,3,6,9,47,18,13
2023-24,11/1/2023,202311010COL,St. Louis Blues,STL,0,COL,1,2,3,28,19,14,4,6,10,28,15,10
2023-24,11/1/2023,202311010PHI,Philadelphia Flyers,PHI,1,BUF,2,2,4,40,33,12,5,9,14,15,18,18
2023-24,10/31/2023,202310310TOR,Los Angeles Kings,LAK,0,TOR,4,7,11,27,19,9,1,2,3,30,21,14
2023-24,10/31/2023,202310310VAN,Nashville Predators,NSH,0,VAN,2,4,6,29,20,12,5,10,15,27,32,12
2023-24,10/31/2023,202310310TOR,Toronto Maple Leafs,TOR,1,LAK,1,2,3,30,21,14,4,7,11,27,19,9
2023-24,10/31/2023,202310310VAN,Vancouver Canucks,VAN,1,NSH,5,10,15,27,32,12,2,4,6,29,20,12
2023-24,10/30/2023,202310300ARI,Arizona Coyotes,ARI,1,CHI,8,14,22,33,17,21,1,2,3,30,33,10
2023-24,10/30/2023,202310300BOS,Boston Bruins,BOS,1,FLA,3,4,7,26,26,22,2,3,5,37,32,19
2023-24,10/30/2023,202310300DAL,Columbus Blue Jackets,CBJ,0,DAL,3,6,9,25,19,15,5,10,15,33,12,17
2023-24,10/30/2023,202310300NYI,Detroit Red Wings,DET,0,NYI,4,7,11,36,12,12,3,5,8,40,25,16
2023-24,10/30/2023,202310300PHI,Carolina Hurricanes,CAR,0,PHI,3,5,8,32,13,4,2,3,5,28,23,10
2023-24,10/30/2023,202310300PIT,Anaheim Ducks,ANA,0,PIT,4,7,11,27,18,27,3,6,9,42,11,13
2023-24,10/30/2023,202310300TBL,Seattle Kraken,SEA,0,TBL,4,8,12,43,22,19,3,6,9,37,21,14
2023-24,10/30/2023,202310300VEG,Montreal Canadiens,MTL,0,VEG,2,2,4,39,21,11,2,4,6,25,26,18
2023-24,10/30/2023,202310300WPG,New York Rangers,NYR,0,WPG,3,6,9,26,31,23,2,3,5,29,18,12
2023-24,10/30/2023,202310300ARI,Chicago Blackhawks,CHI,0,ARI,1,2,3,30,33,10,8,14,22,33,17,21
2023-24,10/30/2023,202310300BOS,Florida Panthers,FLA,0,BOS,2,3,5,37,32,19,3,4,7,26,26,22
2023-24,10/30/2023,202310300DAL,Dallas Stars,DAL,1,CBJ,5,10,15,33,12,17,3,6,9,25,19,15
2023-24,10/30/2023,202310300NYI,New York Islanders,NYI,1,DET,3,5,8,40,25,16,4,7,11,36,12,12
2023-24,10/30/2023,202310300PHI,Philadelphia Flyers,PHI,1,CAR,2,3,5,28,23,10,3,5,8,32,13,4
2023-24,10/30/2023,202310300PIT,Pittsburgh Penguins,PIT,1,ANA,3,6,9,42,11,13,4,7,11,27,18,27
2023-24,10/30/2023,202310300TBL,Tampa Bay Lightning,TBL,1,SEA,3,6,9,37,21,14,4,8,12,43,22,19
2023-24,10/30/2023,202310300VEG,Vegas Golden Knights,VEG,1,MTL,2,4,6,25,26,18,2,2,4,39,21,11
2023-24,10/30/2023,202310300WPG,Winnipeg Jets,WPG,1,NYR,2,3,5,29,18,12,3,6,9,26,31,23
2023-24,10/29/2023,202310290BUF,Buffalo Sabres,BUF,1,COL,4,6,10,29,9,21,0,0,0,23,28,9
2023-24,10/29/2023,202310290EDM,Calgary Flames,CGY,0,EDM,2,3,5,26,29,12,5,8,13,33,36,15
2023-24,10/29/2023,202310290NJD,Minnesota Wild,MIN,0,NJD,3,6,9,34,14,16,4,6,10,30,10,19
2023-24,10/29/2023,202310290WSH,San Jose Sharks,SJS,0,WSH,1,2,3,31,23,24,3,6,9,42,27,20
2023-24,10/29/2023,202310290BUF,Colorado Avalanche,COL,0,BUF,0,0,0,23,28,9,4,6,10,29,9,21
2023-24,10/29/2023,202310290EDM,Edmonton Oilers,EDM,1,CGY,5,8,13,33,36,15,2,3,5,26,29,12
2023-24,10/29/2023,202310290NJD,New Jersey Devils,NJD,1,MIN,4,6,10,30,10,19,3,6,9,34,14,16
2023-24,10/29/2023,202310290WSH,Washington Capitals,WSH,1,SJS,3,6,9,42,27,20,1,2,3,31,23,24
2023-24,10/28/2023,202310280BOS,Boston Bruins,BOS,1,DET,4,2,6,31,32,22,1,1,2,24,33,10
2023-24,10/28/2023,202310280CBJ,Columbus Blue Jackets,CBJ,1,NYI,0,0,0,34,10,15,2,3,5,34,14,19
2023-24,10/28/2023,202310280FLA,Florida Panthers,FLA,1,SEA,3,6,9,37,22,9,2,4,6,33,22,15
2023-24,10/28/2023,202310280LAK,Los Angeles Kings,LAK,1,VEG,3,6,9,40,20,11,3,3,6,30,23,24
2023-24,10/28/2023,202310280MTL,Montreal Canadiens,MTL,1,WPG,3,5,8,29,22,19,3,3,6,45,11,10
2023-24,10/28/2023,202310280NSH,Nashville Predators,NSH,1,TOR,3,6,9,24,28,21,2,3,5,35,20,13
2023-24,10/28/2023,202310280PHI,Anaheim Ducks,ANA,0,PHI,7,11,18,25,14,19,4,8,12,30,13,12
2023-24,10/28/2023,202310280PIT,Ottawa Senators,OTT,0,PIT,5,9,14,26,19,22,2,4,6,43,29,10
2023-24,10/28/2023,202310280VAN,New York Rangers,NYR,0,VAN,4,6,10,24,19,18,3,4,7,33,21,11
2023-24,10/28/2023,202310280BOS,Detroit Red Wings,DET,0,BOS,1,1,2,24,33,10,4,2,6,31,32,22
2023-24,10/28/2023,202310280CBJ,New York Islanders,NYI,0,CBJ,2,3,5,34,14,19,0,0,0,34,10,15
2023-24,10/28/2023,202310280FLA,Seattle Kraken,SEA,0,FLA,2,4,6,33,22,15,3,6,9,37,22,9
2023-24,10/28/2023,202310280LAK,Vegas Golden Knights,VEG,0,LAK,3,3,6,30,23,24,3,6,9,40,20,11
2023-24,10/28/2023,202310280MTL,Winnipeg Jets,WPG,0,MTL,3,3,6,45,11,10,3,5,8,29,22,19
2023-24,10/28/2023,202310280NSH,Toronto Maple Leafs,TOR,0,NSH,2,3,5,35,20,13,3,6,9,24,28,21
2023-24,10/28/2023,202310280PHI,Philadelphia Flyers,PHI,1,ANA,4,8,12,30,13,12,7,11,18,25,14,19
2023-24,10/28/2023,202310280PIT,Pittsburgh Penguins,PIT,1,OTT,2,4,6,43,29,10,5,9,14,26,19,22
2023-24,10/28/2023,202310280VAN,Vancouver Canucks,VAN,1,NYR,3,4,7,33,21,11,4,6,10,24,19,18
2023-24,10/27/2023,202310270ARI,Arizona Coyotes,ARI,1,LAK,4,7,11,24,30,20,5,8,13,41,25,9
2023-24,10/27/2023,202310270CAR,Carolina Hurricanes,CAR,1,SJS,3,6,9,40,20,11,0,0,0,20,20,19
2023-24,10/27/2023,202310270NJD,Buffalo Sabres,BUF,0,NJD,4,7,11,27,16,21,5,6,11,39,14,12
2023-24,10/27/2023,202310270VAN,St. Louis Blues,STL,0,VAN,0,0,0,22,29,18,5,8,13,35,12,2
2023-24,10/27/2023,202310270VEG,Chicago Blackhawks,CHI,0,VEG,4,4,8,24,24,15,3,5,8,21,23,16
2023-24,10/27/2023,202310270WSH,Minnesota Wild,MIN,0,WSH,2,2,4,41,13,15,2,4,6,33,9,16
2023-24,10/27/2023,202310270ARI,Los Angeles Kings,LAK,0,ARI,5,8,13,41,25,9,4,7,11,24,30,20
2023-24,10/27/2023,202310270CAR,San Jose Sharks,SJS,0,CAR,0,0,0,20,20,19,3,6,9,40,20,11
2023-24,10/27/2023,202310270NJD,New Jersey Devils,NJD,1,BUF,5,6,11,39,14,12,4,7,11,27,16,21
2023-24,10/27/2023,202310270VAN,Vancouver Canucks,VAN,1,STL,5,8,13,35,12,2,0,0,0,22,29,18
2023-24,10/27/2023,202310270VEG,Vegas Golden Knights,VEG,1,CHI,3,5,8,21,23,16,4,4,8,24,24,15
2023-24,10/27/2023,202310270WSH,Washington Capitals,WSH,1,MIN,2,4,6,33,9,16,2,2,4,41,13,15
2023-24,10/26/2023,202310260BOS,Anaheim Ducks,ANA,0,BOS,4,8,12,32,26,14,3,6,9,30,25,12
2023-24,10/26/2023,202310260CAR,Carolina Hurricanes,CAR,1,SEA,3,6,9,45,18,13,2,3,5,26,20,19
2023-24,10/26/2023,202310260CGY,Calgary Flames,CGY,1,STL,0,0,0,27,16,13,3,4,7,35,19,11
2023-24,10/26/2023,202310260DAL,Dallas Stars,DAL,1,TOR,1,2,3,32,19,13,4,5,9,24,10,23
2023-24,10/26/2023,202310260DET,Detroit Red Wings,DET,1,WPG,1,2,3,36,26,16,4,6,10,29,14,18
2023-24,10/26/2023,202310260EDM,Edmonton Oilers,EDM,1,NYR,0,0,0,29,19,13,3,6,9,32,20,18
2023-24,10/26/2023,202310260MTL,Columbus Blue Jackets,CBJ,0,MTL,3,6,9,36,18,23,4,6,10,29,25,24
2023-24,10/26/2023,202310260NYI,New York Islanders,NYI,1,OTT,3,5,8,38,26,16,2,4,6,47,14,21
2023-24,10/26/2023,202310260PHI,Minnesota Wild,MIN,0,PHI,2,4,6,28,12,15,6,10,16,35,19,16
2023-24,10/26/2023,202310260PIT,Colorado Avalanche,COL,0,PIT,0,0,0,31,19,9,4,4,8,29,18,14
2023-24,10/26/2023,202310260TBL,San Jose Sharks,SJS,0,TBL,0,0,0,23,32,20,6,12,18,31,24,11
2023-24,10/26/2023,202310260BOS,Boston Bruins,BOS,1,ANA,3,6,9,30,25,12,4,8,12,32,26,14
2023-24,10/26/2023,202310260CAR,Seattle Kraken,SEA,0,CAR,2,3,5,26,20,19,3,6,9,45,18,13
2023-24,10/26/2023,202310260CGY,St. Louis Blues,STL,0,CGY,3,4,7,35,19,11,0,0,0,27,16,13
2023-24,10/26/2023,202310260DAL,Toronto Maple Leafs,TOR,0,DAL,4,5,9,24,10,23,1,2,3,32,19,13
2023-24,10/26/2023,202310260DET,Winnipeg Jets,WPG,0,DET,4,6,10,29,14,18,1,2,3,36,26,16
2023-24,10/26/2023,202310260EDM,New York Rangers,NYR,0,EDM,3,6,9,32,20,18,0,0,0,29,19,13
2023-24,10/26/2023,202310260MTL,Montreal Canadiens,MTL,1,CBJ,4,6,10,29,25,24,3,6,9,36,18,23
2023-24,10/26/2023,202310260NYI,Ottawa Senators,OTT,0,NYI,2,4,6,47,14,21,3,5,8,38,26,16
2023-24,10/26/2023,202310260PHI,Philadelphia Flyers,PHI,1,MIN,6,10,16,35,19,16,2,4,6,28,12,15
2023-24,10/26/2023,202310260PIT,Pittsburgh Penguins,PIT,1,COL,4,4,8,29,18,14,0,0,0,31,19,9
2023-24,10/26/2023,202310260TBL,Tampa Bay Lightning,TBL,1,SJS,6,12,18,31,24,11,0,0,0,23,32,20
2023-24,10/25/2023,202310250NJD,New Jersey Devils,NJD,1,WSH,4,8,12,22,33,11,6,9,15,25,25,19
2023-24,10/25/2023,202310250NJD,Washington Capitals,WSH,0,NJD,6,9,15,25,25,19,4,8,12,22,33,11
2023-24,10/24/2023,202310240CBJ,Anaheim Ducks,ANA,0,CBJ,3,4,7,27,22,21,2,4,6,37,12,16
2023-24,10/24/2023,202310240CGY,Calgary Flames,CGY,1,NYR,1,2,3,26,16,10,3,6,9,20,15,23
2023-24,10/24/2023,202310240CHI,Boston Bruins,BOS,0,CHI,3,5,8,43,16,13,0,0,0,23,15,13
2023-24,10/24/2023,202310240DET,Detroit Red Wings,DET,1,SEA,4,8,12,27,25,20,5,9,14,38,24,16
2023-24,10/24/2023,202310240FLA,Florida Panthers,FLA,1,SJS,3,6,9,36,25,10,1,2,3,28,27,23
2023-24,10/24/2023,202310240LAK,Arizona Coyotes,ARI,0,LAK,3,6,9,27,15,13,6,11,17,28,22,10
2023-24,10/24/2023,202310240MIN,Edmonton Oilers,EDM,0,MIN,4,8,12,28,17,13,7,13,20,32,25,16
2023-24,10/24/2023,202310240MTL,Montreal Canadiens,MTL,1,NJD,2,2,4,29,14,20,5,7,12,34,20,12
2023-24,10/24/2023,202310240NSH,Nashville Predators,NSH,1,VAN,2,1,3,18,24,23,3,5,8,24,27,15
2023-24,10/24/2023,202310240NYI,Colorado Avalanche,COL,0,NYI,7,9,16,39,5,11,4,6,10,32,26,20
2023-24,10/24/2023,202310240OTT,Buffalo Sabres,BUF,0,OTT,6,10,16,24,19,16,4,8,12,38,24,9
2023-24,10/24/2023,202310240PIT,Dallas Stars,DAL,0,PIT,4,7,11,34,12,19,1,2,3,39,15,9
2023-24,10/24/2023,202310240TBL,Carolina Hurricanes,CAR,0,TBL,0,0,0,32,11,6,3,6,9,23,13,17
2023-24,10/24/2023,202310240VEG,Philadelphia Flyers,PHI,0,VEG,2,4,6,28,22,29,3,6,9,29,20,18
2023-24,10/24/2023,202310240WPG,St. Louis Blues,STL,0,WPG,2,3,5,20,23,17,4,7,11,30,16,9
2023-24,10/24/2023,202310240WSH,Toronto Maple Leafs,TOR,0,WSH,4,7,11,17,14,13,1,2,3,38,17,14
2023-24,10/24/2023,202310240CBJ,Columbus Blue Jackets,CBJ,1,ANA,2,4,6,37,12,16,3,4,7,27,22,21
2023-24,10/24/2023,202310240CGY,New York Rangers,NYR,0,CGY,3,6,9,20,15,23,1,2,3,26,16,10
2023-24,10/24/2023,202310240CHI,Chicago Blackhawks,CHI,1,BOS,0,0,0,23,15,13,3,5,8,43,16,13
2023-24,10/24/2023,202310240DET,Seattle Kraken,SEA,0,DET,5,9,14,38,24,16,4,8,12,27,25,20
2023-24,10/24/2023,202310240FLA,San Jose Sharks,SJS,0,FLA,1,2,3,28,27,23,3,6,9,36,25,10
2023-24,10/24/2023,202310240LAK,Los Angeles Kings,LAK,1,ARI,6,11,17,28,22,10,3,6,9,27,15,13
2023-24,10/24/2023,202310240MIN,Minnesota Wild,MIN,1,EDM,7,13,20,32,25,16,4,8,12,28,17,13
2023-24,10/24/2023,202310240MTL,New Jersey Devils,NJD,0,MTL,5,7,12,34,20,12,2,2,4,29,14,20
2023-24,10/24/2023,202310240NSH,Vancouver Canucks,VAN,0,NSH,3,5,8,24,27,15,2,1,3,18,24,23
2023-24,10/24/2023,202310240NYI,New York Islanders,NYI,1,COL,4,6,10,32,26,20,7,9,16,39,5,11
2023-24,10/24/2023,202310240OTT,Ottawa Senators,OTT,1,BUF,4,8,12,38,24,9,6,10,16,24,19,16
2023-24,10/24/2023,202310240PIT,Pittsburgh Penguins,PIT,1,DAL,1,2,3,39,15,9,4,7,11,34,12,19
2023-24,10/24/2023,202310240TBL,Tampa Bay Lightning,TBL,1,CAR,3,6,9,23,13,17,0,0,0,32,11,6
2023-24,10/24/2023,202310240VEG,Vegas Golden Knights,VEG,1,PHI,3,6,9,29,20,18,2,4,6,28,22,29
2023-24,10/24/2023,202310240WPG,Winnipeg Jets,WPG,1,STL,4,7,11,30,16,9,2,3,5,20,23,17
2023-24,10/24/2023,202310240WSH,Washington Capitals,WSH,1,TOR,1,2,3,38,17,14,4,7,11,17,14,13
2023-24,10/23/2023,202310230BUF,Buffalo Sabres,BUF,1,MTL,1,2,3,37,26,10,3,6,9,27,34,17
2023-24,10/23/2023,202310230BUF,Montreal Canadiens,MTL,0,BUF,3,6,9,27,34,17,1,2,3,37,26,10
2023-24,10/22/2023,202310220ANA,Anaheim Ducks,ANA,1,BOS,1,2,3,31,27,14,3,5,8,26,23,11
2023-24,10/22/2023,202310220DET,Calgary Flames,CGY,0,DET,2,4,6,31,16,12,6,11,17,30,6,9
2023-24,10/22/2023,202310220ANA,Boston Bruins,BOS,0,ANA,3,5,8,26,23,11,1,2,3,31,27,14
2023-24,10/22/2023,202310220DET,Detroit Red Wings,DET,1,CGY,6,11,17,30,6,9,2,4,6,31,16,12
2023-24,10/21/2023,202310210ARI,Anaheim Ducks,ANA,0,ARI,1,2,3,33,34,16,2,4,6,27,24,16
2023-24,10/21/2023,202310210BUF,Buffalo Sabres,BUF,1,NYI,3,5,8,42,19,12,1,2,3,25,44,22
2023-24,10/21/2023,202310210CHI,Chicago Blackhawks,CHI,1,VEG,3,5,8,24,23,18,5,10,15,24,27,16
2023-24,10/21/2023,202310210COL,Carolina Hurricanes,CAR,0,COL,4,8,12,27,14,7,6,11,17,27,12,13
2023-24,10/21/2023,202310210DAL,Dallas Stars,DAL,1,PHI,5,7,12,25,17,17,4,6,10,40,27,16
2023-24,10/21/2023,202310210EDM,Edmonton Oilers,EDM,1,WPG,2,4,6,40,22,13,3,5,8,27,17,9
2023-24,10/21/2023,202310210FLA,Florida Panthers,FLA,1,VAN,3,4,7,37,31,13,5,7,12,31,28,16
2023-24,10/21/2023,202310210LAK,Boston Bruins,BOS,0,LAK,4,8,12,25,33,21,2,4,6,34,21,14
2023-24,10/21/2023,202310210MIN,Columbus Blue Jackets,CBJ,0,MIN,5,8,13,54,9,27,4,7,11,28,16,23
2023-24,10/21/2023,202310210MTL,Montreal Canadiens,MTL,1,WSH,3,6,9,28,22,17,2,4,6,33,20,19
2023-24,10/21/2023,202310210NSH,Nashville Predators,NSH,1,SJS,5,9,14,34,19,20,1,2,3,32,18,13
2023-24,10/21/2023,202310210OTT,Detroit Red Wings,DET,0,OTT,5,8,13,23,23,17,2,4,6,37,25,11
2023-24,10/21/2023,202310210SEA,New York Rangers,NYR,0,SEA,4,6,10,27,30,16,1,2,3,19,29,7
2023-24,10/21/2023,202310210STL,Pittsburgh Penguins,PIT,0,STL,2,3,5,33,11,9,4,8,12,21,25,25
2023-24,10/21/2023,202310210TBL,Tampa Bay Lightning,TBL,1,TOR,3,6,9,31,15,15,4,7,11,52,14,20
2023-24,10/21/2023,202310210ARI,Arizona Coyotes,ARI,1,ANA,2,4,6,27,24,16,1,2,3,33,34,16
2023-24,10/21/2023,202310210BUF,New York Islanders,NYI,0,BUF,1,2,3,25,44,22,3,5,8,42,19,12
2023-24,10/21/2023,202310210CHI,Vegas Golden Knights,VEG,0,CHI,5,10,15,24,27,16,3,5,8,24,23,18
2023-24,10/21/2023,202310210COL,Colorado Avalanche,COL,1,CAR,6,11,17,27,12,13,4,8,12,27,14,7
2023-24,10/21/2023,202310210DAL,Philadelphia Flyers,PHI,0,DAL,4,6,10,40,27,16,5,7,12,25,17,17
2023-24,10/21/2023,202310210EDM,Winnipeg Jets,WPG,0,EDM,3,5,8,27,17,9,2,4,6,40,22,13
2023-24,10/21/2023,202310210FLA,Vancouver Canucks,VAN,0,FLA,5,7,12,31,28,16,3,4,7,37,31,13
2023-24,10/21/2023,202310210LAK,Los Angeles Kings,LAK,1,BOS,2,4,6,34,21,14,4,8,12,25,33,21
2023-24,10/21/2023,202310210MIN,Minnesota Wild,MIN,1,CBJ,4,7,11,28,16,23,5,8,13,54,9,27
2023-24,10/21/2023,202310210MTL,Washington Capitals,WSH,0,MTL,2,4,6,33,20,19,3,6,9,28,22,17
2023-24,10/21/2023,202310210NSH,San Jose Sharks,SJS,0,NSH,1,2,3,32,18,13,5,9,14,34,19,20
2023-24,10/21/2023,202310210OTT,Ottawa Senators,OTT,1,DET,2,4,6,37,25,11,5,8,13,23,23,17
2023-24,10/21/2023,202310210SEA,Seattle Kraken,SEA,1,NYR,1,2,3,19,29,7,4,6,10,27,30,16
2023-24,10/21/2023,202310210STL,St. Louis Blues,STL,1,PIT,4,8,12,21,25,25,2,3,5,33,11,9
2023-24,10/21/2023,202310210TBL,Toronto Maple Leafs,TOR,0,TBL,4,7,11,52,14,20,3,6,9,31,15,15
2023-24,10/20/2023,202310200CBJ,Columbus Blue Jackets,CBJ,1,CGY,3,4,7,29,9,17,1,1,2,37,23,18
2023-24,10/20/2023,202310200NYI,New Jersey Devils,NJD,0,NYI,5,9,14,39,15,9,4,7,11,32,28,24
2023-24,10/20/2023,202310200CBJ,Calgary Flames,CGY,0,CBJ,1,1,2,37,23,18,3,4,7,29,9,17
2023-24,10/20/2023,202310200NYI,New York Islanders,NYI,1,NJD,4,7,11,32,28,24,5,9,14,39,15,9
2023-24,10/19/2023,202310190ANA,Anaheim Ducks,ANA,1,DAL,2,3,5,29,27,12,3,6,9,24,18,19
2023-24,10/19/2023,202310190BUF,Buffalo Sabres,BUF,1,CGY,3,6,9,27,22,12,4,8,12,36,12,17
2023-24,10/19/2023,202310190COL,Chicago Blackhawks,CHI,0,COL,0,0,0,18,17,16,4,8,12,41,9,9
2023-24,10/19/2023,202310190FLA,Florida Panthers,FLA,1,TOR,3,3,6,24,23,26,1,2,3,30,31,17
2023-24,10/19/2023,202310190MIN,Los Angeles Kings,LAK,0,MIN,7,9,16,27,22,8,3,6,9,32,28,13
2023-24,10/19/2023,202310190NYR,Nashville Predators,NSH,0,NYR,4,6,10,27,25,21,1,2,3,24,33,10
2023-24,10/19/2023,202310190PHI,Edmonton Oilers,EDM,0,PHI,1,2,3,23,17,6,4,6,10,32,16,19
2023-24,10/19/2023,202310190SEA,Carolina Hurricanes,CAR,0,SEA,4,8,12,36,16,17,7,12,19,36,23,19
2023-24,10/19/2023,202310190SJS,Boston Bruins,BOS,0,SJS,3,4,7,36,15,18,1,1,2,27,27,10
2023-24,10/19/2023,202310190STL,Arizona Coyotes,ARI,0,STL,6,8,14,42,15,9,2,3,5,26,26,14
2023-24,10/19/2023,202310190TBL,Tampa Bay Lightning,TBL,1,VAN,4,7,11,36,18,23,3,4,7,29,21,11
2023-24,10/19/2023,202310190WPG,Vegas Golden Knights,VEG,0,WPG,5,8,13,27,23,17,3,6,9,39,25,22
2023-24,10/19/2023,202310190ANA,Dallas Stars,DAL,0,ANA,3,6,9,24,18,19,2,3,5,29,27,12
2023-24,10/19/2023,202310190BUF,Calgary Flames,CGY,0,BUF,4,8,12,36,12,17,3,6,9,27,22,12
2023-24,10/19/2023,202310190COL,Colorado Avalanche,COL,1,CHI,4,8,12,41,9,9,0,0,0,18,17,16
2023-24,10/19/2023,202310190FLA,Toronto Maple Leafs,TOR,0,FLA,1,2,3,30,31,17,3,3,6,24,23,26
2023-24,10/19/2023,202310190MIN,Minnesota Wild,MIN,1,LAK,3,6,9,32,28,13,7,9,16,27,22,8
2023-24,10/19/2023,202310190NYR,New York Rangers,NYR,1,NSH,1,2,3,24,33,10,4,6,10,27,25,21
2023-24,10/19/2023,202310190PHI,Philadelphia Flyers,PHI,1,EDM,4,6,10,32,16,19,1,2,3,23,17,6
2023-24,10/19/2023,202310190SEA,Seattle Kraken,SEA,1,CAR,7,12,19,36,23,19,4,8,12,36,16,17
2023-24,10/19/2023,202310190SJS,San Jose Sharks,SJS,1,BOS,1,1,2,27,27,10,3,4,7,36,15,18
2023-24,10/19/2023,202310190STL,St. Louis Blues,STL,1,ARI,2,3,5,26,26,14,6,8,14,42,15,9
2023-24,10/19/2023,202310190TBL,Vancouver Canucks,VAN,0,TBL,3,4,7,29,21,11,4,7,11,36,18,23
2023-24,10/19/2023,202310190WPG,Winnipeg Jets,WPG,1,VEG,3,6,9,39,25,22,5,8,13,27,23,17
2023-24,10/18/2023,202310180DET,Detroit Red Wings,DET,1,PIT,6,9,15,29,14,20,3,6,9,33,14,8
2023-24,10/18/2023,202310180OTT,Ottawa Senators,OTT,1,WSH,6,11,17,29,16,14,1,2,3,24,20,22
2023-24,10/18/2023,202310180DET,Pittsburgh Penguins,PIT,0,DET,3,6,9,33,14,8,6,9,15,29,14,20
2023-24,10/18/2023,202310180OTT,Washington Capitals,WSH,0,OTT,1,2,3,24,20,22,6,11,17,29,16,14
2023-24,10/17/2023,202310170BUF,Buffalo Sabres,BUF,1,TBL,3,6,9,31,14,12,2,3,5,25,20,10
2023-24,10/17/2023,202310170MTL,Minnesota Wild,MIN,0,MTL,5,7,12,35,10,7,2,2,4,28,29,20
2023-24,10/17/2023,202310170NSH,Edmonton Oilers,EDM,0,NSH,6,12,18,30,26,13,1,1,2,44,28,10
2023-24,10/17/2023,202310170NYI,Arizona Coyotes,ARI,0,NYI,0,0,0,14,18,13,1,2,3,34,28,14
2023-24,10/17/2023,202310170PHI,Philadelphia Flyers,PHI,1,VAN,2,2,4,42,15,15,0,0,0,26,21,11
2023-24,10/17/2023,202310170SEA,Colorado Avalanche,COL,0,SEA,4,4,8,28,11,22,1,1,2,38,22,15
2023-24,10/17/2023,202310170SJS,Carolina Hurricanes,CAR,0,SJS,6,10,16,42,12,10,3,4,7,16,13,32
2023-24,10/17/2023,202310170VEG,Dallas Stars,DAL,0,VEG,2,3,5,26,23,17,2,4,6,34,49,19
2023-24,10/17/2023,202310170WPG,Los Angeles Kings,LAK,0,WPG,5,7,12,29,20,17,1,2,3,27,24,9
2023-24,10/17/2023,202310170BUF,Tampa Bay Lightning,TBL,0,BUF,2,3,5,25,20,10,3,6,9,31,14,12
2023-24,10/17/2023,202310170MTL,Montreal Canadiens,MTL,1,MIN,2,2,4,28,29,20,5,7,12,35,10,7
2023-24,10/17/2023,202310170NSH,Nashville Predators,NSH,1,EDM,1,1,2,44,28,10,6,12,18,30,26,13
2023-24,10/17/2023,202310170NYI,New York Islanders,NYI,1,ARI,1,2,3,34,28,14,0,0,0,14,18,13
2023-24,10/17/2023,202310170PHI,Vancouver Canucks,VAN,0,PHI,0,0,0,26,21,11,2,2,4,42,15,15
2023-24,10/17/2023,202310170SEA,Seattle Kraken,SEA,1,COL,1,1,2,38,22,15,4,4,8,28,11,22
2023-24,10/17/2023,202310170SJS,San Jose Sharks,SJS,1,CAR,3,4,7,16,13,32,6,10,16,42,12,10
2023-24,10/17/2023,202310170VEG,Vegas Golden Knights,VEG,1,DAL,2,4,6,34,49,19,2,3,5,26,23,17
2023-24,10/17/2023,202310170WPG,Winnipeg Jets,WPG,1,LAK,1,2,3,27,24,9,5,7,12,29,20,17
2023-24,10/16/2023,202310160CBJ,Columbus Blue Jackets,CBJ,1,DET,0,0,0,23,15,10,4,7,11,28,11,13
2023-24,10/16/2023,202310160NJD,Florida Panthers,FLA,0,NJD,4,7,11,30,31,22,3,5,8,34,40,9
2023-24,10/16/2023,202310160NYR,Arizona Coyotes,ARI,0,NYR,1,2,3,27,20,14,2,4,6,28,23,15
2023-24,10/16/2023,202310160TOR,Chicago Blackhawks,CHI,0,TOR,4,6,10,31,42,28,1,2,3,36,27,23
2023-24,10/16/2023,202310160WSH,Calgary Flames,CGY,0,WSH,2,4,6,40,11,14,2,3,5,23,17,20
2023-24,10/16/2023,202310160CBJ,Detroit Red Wings,DET,0,CBJ,4,7,11,28,11,13,0,0,0,23,15,10
2023-24,10/16/2023,202310160NJD,New Jersey Devils,NJD,1,FLA,3,5,8,34,40,9,4,7,11,30,31,22
2023-24,10/16/2023,202310160NYR,New York Rangers,NYR,1,ARI,2,4,6,28,23,15,1,2,3,27,20,14
2023-24,10/16/2023,202310160TOR,Toronto Maple Leafs,TOR,1,CHI,1,2,3,36,27,23,4,6,10,31,42,28
2023-24,10/16/2023,202310160WSH,Washington Capitals,WSH,1,CGY,2,3,5,23,17,20,2,4,6,40,11,14
2023-24,10/15/2023,202310150ANA,Anaheim Ducks,ANA,1,CAR,6,10,16,25,16,29,3,6,9,35,13,9
2023-24,10/15/2023,202310150OTT,Ottawa Senators,OTT,1,TBL,5,7,12,38,17,15,2,4,6,24,26,15
2023-24,10/15/2023,202310150ANA,Carolina Hurricanes,CAR,0,ANA,3,6,9,35,13,9,6,10,16,25,16,29
2023-24,10/15/2023,202310150OTT,Tampa Bay Lightning,TBL,0,OTT,2,4,6,24,26,15,5,7,12,38,17,15
2023-24,10/14/2023,202310140BOS,Boston Bruins,BOS,1,NSH,3,4,7,30,30,16,2,4,6,36,33,21
2023-24,10/14/2023,202310140CBJ,Columbus Blue Jackets,CBJ,1,NYR,5,9,14,21,25,27,3,6,9,42,23,12
2023-24,10/14/2023,202310140DET,Detroit Red Wings,DET,1,TBL,6,6,12,42,22,21,4,7,11,25,27,11
2023-24,10/14/2023,202310140EDM,Edmonton Oilers,EDM,1,VAN,3,6,9,40,39,9,4,6,10,16,36,25
2023-24,10/14/2023,202310140LAK,Carolina Hurricanes,CAR,0,LAK,5,4,9,19,13,17,5,8,13,30,24,14
2023-24,10/14/2023,202310140MTL,Chicago Blackhawks,CHI,0,MTL,2,4,6,30,23,21,3,4,7,36,15,20
2023-24,10/14/2023,202310140NYI,Buffalo Sabres,BUF,0,NYI,2,4,6,28,25,16,3,5,8,29,32,15
2023-24,10/14/2023,202310140OTT,Ottawa Senators,OTT,1,PHI,5,9,14,31,21,18,2,4,6,21,23,8
2023-24,10/14/2023,202310140PIT,Calgary Flames,CGY,0,PIT,2,4,6,36,12,5,5,8,13,29,19,24
2023-24,10/14/2023,202310140SJS,Colorado Avalanche,COL,0,SJS,1,1,2,52,20,18,1,2,3,21,26,27
2023-24,10/14/2023,202310140STL,Seattle Kraken,SEA,0,STL,1,2,3,31,23,13,1,1,2,25,21,17
2023-24,10/14/2023,202310140TOR,Minnesota Wild,MIN,0,TOR,4,8,12,32,41,10,7,11,18,33,26,19
2023-24,10/14/2023,202310140VEG,Anaheim Ducks,ANA,0,VEG,1,2,3,23,29,18,4,8,12,38,22,14
2023-24,10/14/2023,202310140WPG,Florida Panthers,FLA,0,WPG,4,8,12,33,16,10,6,10,16,35,16,16
2023-24,10/14/2023,202310140BOS,Nashville Predators,NSH,0,BOS,2,4,6,36,33,21,3,4,7,30,30,16
2023-24,10/14/2023,202310140CBJ,New York Rangers,NYR,0,CBJ,3,6,9,42,23,12,5,9,14,21,25,27
2023-24,10/14/2023,202310140DET,Tampa Bay Lightning,TBL,0,DET,4,7,11,25,27,11,6,6,12,42,22,21
2023-24,10/14/2023,202310140EDM,Vancouver Canucks,VAN,0,EDM,4,6,10,16,36,25,3,6,9,40,39,9
2023-24,10/14/2023,202310140LAK,Los Angeles Kings,LAK,1,CAR,5,8,13,30,24,14,5,4,9,19,13,17
2023-24,10/14/2023,202310140MTL,Montreal Canadiens,MTL,1,CHI,3,4,7,36,15,20,2,4,6,30,23,21
2023-24,10/14/2023,202310140NYI,New York Islanders,NYI,1,BUF,3,5,8,29,32,15,2,4,6,28,25,16
2023-24,10/14/2023,202310140OTT,Philadelphia Flyers,PHI,0,OTT,2,4,6,21,23,8,5,9,14,31,21,18
2023-24,10/14/2023,202310140PIT,Pittsburgh Penguins,PIT,1,CGY,5,8,13,29,19,24,2,4,6,36,12,5
2023-24,10/14/2023,202310140SJS,San Jose Sharks,SJS,1,COL,1,2,3,21,26,27,1,1,2,52,20,18
2023-24,10/14/2023,202310140STL,St. Louis Blues,STL,1,SEA,1,1,2,25,21,17,1,2,3,31,23,13
2023-24,10/14/2023,202310140TOR,Toronto Maple Leafs,TOR,1,MIN,7,11,18,33,26,19,4,8,12,32,41,10
2023-24,10/14/2023,202310140VEG,Vegas Golden Knights,VEG,1,ANA,4,8,12,38,22,14,1,2,3,23,29,18
2023-24,10/14/2023,202310140WPG,Winnipeg Jets,WPG,1,FLA,6,10,16,35,16,16,4,8,12,33,16,10
2023-24,10/13/2023,202310130NJD,Arizona Coyotes,ARI,0,NJD,3,5,8,33,22,16,3,6,9,36,23,13
2023-24,10/13/2023,202310130WSH,Pittsburgh Penguins,PIT,0,WSH,4,7,11,35,19,22,0,0,0,19,20,18
2023-24,10/13/2023,202310130NJD,New Jersey Devils,NJD,1,ARI,3,6,9,36,23,13,3,5,8,33,22,16
2023-24,10/13/2023,202310130WSH,Washington Capitals,WSH,1,PIT,0,0,0,19,20,18,4,7,11,35,19,22
2023-24,10/12/2023,202310120BUF,Buffalo Sabres,BUF,1,NYR,1,2,3,25,29,14,5,8,13,31,18,23
2023-24,10/12/2023,202310120CBJ,Columbus Blue Jackets,CBJ,1,PHI,2,4,6,33,22,24,4,5,9,37,18,17
2023-24,10/12/2023,202310120DAL,Dallas Stars,DAL,1,STL,1,2,3,34,18,15,1,2,3,24,26,18
2023-24,10/12/2023,202310120MIN,Florida Panthers,FLA,0,MIN,0,0,0,41,11,11,2,4,6,21,17,26
2023-24,10/12/2023,202310120NJD,Detroit Red Wings,DET,0,NJD,3,4,7,35,25,14,4,6,10,27,33,11
2023-24,10/12/2023,202310120NSH,Nashville Predators,NSH,1,SEA,3,3,6,35,33,21,0,0,0,23,22,19
2023-24,10/12/2023,202310120SJS,San Jose Sharks,SJS,1,VEG,1,2,3,23,25,17,4,8,12,32,16,10
2023-24,10/12/2023,202310120BUF,New York Rangers,NYR,0,BUF,5,8,13,31,18,23,1,2,3,25,29,14
2023-24,10/12/2023,202310120CBJ,Philadelphia Flyers,PHI,0,CBJ,4,5,9,37,18,17,2,4,6,33,22,24
2023-24,10/12/2023,202310120DAL,St. Louis Blues,STL,0,DAL,1,2,3,24,26,18,1,2,3,34,18,15
2023-24,10/12/2023,202310120MIN,Minnesota Wild,MIN,1,FLA,2,4,6,21,17,26,0,0,0,41,11,11
2023-24,10/12/2023,202310120NJD,New Jersey Devils,NJD,1,DET,4,6,10,27,33,11,3,4,7,35,25,14
2023-24,10/12/2023,202310120NSH,Seattle Kraken,SEA,0,NSH,0,0,0,23,22,19,3,3,6,35,33,21
2023-24,10/12/2023,202310120SJS,Vegas Golden Knights,VEG,0,SJS,4,8,12,32,16,10,1,2,3,23,25,17
2023-24,10/11/2023,202310110BOS,Boston Bruins,BOS,1,CHI,3,5,8,33,25,9,1,2,3,21,24,24
2023-24,10/11/2023,202310110CAR,Carolina Hurricanes,CAR,1,OTT,5,9,14,42,25,9,3,3,6,30,24,16
2023-24,10/11/2023,202310110CGY,Calgary Flames,CGY,1,WPG,5,9,14,22,19,25,3,5,8,37,26,14
2023-24,10/11/2023,202310110LAK,Colorado Avalanche,COL,0,LAK,5,10,15,37,25,23,2,2,4,36,20,13
2023-24,10/11/2023,202310110TOR,Montreal Canadiens,MTL,0,TOR,5,7,12,24,43,15,5,8,13,42,29,13
2023-24,10/11/2023,202310110VAN,Edmonton Oilers,EDM,0,VAN,1,2,3,27,26,10,8,16,24,32,25,13
2023-24,10/11/2023,202310110BOS,Chicago Blackhawks,CHI,0,BOS,1,2,3,21,24,24,3,5,8,33,25,9
2023-24,10/11/2023,202310110CAR,Ottawa Senators,OTT,0,CAR,3,3,6,30,24,16,5,9,14,42,25,9
2023-24,10/11/2023,202310110CGY,Winnipeg Jets,WPG,0,CGY,3,5,8,37,26,14,5,9,14,22,19,25
2023-24,10/11/2023,202310110LAK,Los Angeles Kings,LAK,1,COL,2,2,4,36,20,13,5,10,15,37,25,23
2023-24,10/11/2023,202310110TOR,Toronto Maple Leafs,TOR,1,MTL,5,8,13,42,29,13,5,7,12,24,43,15
2023-24,10/11/2023,202310110VAN,Vancouver Canucks,VAN,1,EDM,8,16,24,32,25,13,1,2,3,27,26,10
2023-24,10/10/2023,202310100PIT,Chicago Blackhawks,CHI,0,PIT,4,8,12,36,13,16,2,4,6,41,23,19
2023-24,10/10/2023,202310100TBL,Nashville Predators,NSH,0,TBL,3,6,9,31,23,10,5,7,12,34,22,17
2023-24,10/10/2023,202310100VEG,Seattle Kraken,SEA,0,VEG,1,1,2,33,21,18,4,5,9,28,29,21
2023-24,10/10/2023,202310100PIT,Pittsburgh Penguins,PIT,1,CHI,2,4,6,41,23,19,4,8,12,36,13,16
2023-24,10/10/2023,202310100TBL,Tampa Bay Lightning,TBL,1,NSH,5,7,12,34,22,17,3,6,9,31,23,10
2023-24,10/10/2023,202310100VEG,Vegas Golden Knights,VEG,1,SEA,4,5,9,28,29,21,1,1,2,33,21,18
2022-23,4/14/2023,202304140CBJ,Buffalo Sabres,BUF,0,CBJ,5,5,10,32,4,10,2,2,4,19,1,6
2022-23,4/14/2023,202304140NSH,Colorado Avalanche,COL,0,NSH,4,6,10,34,12,12,3,4,7,18,21,20
2022-23,4/14/2023,202304140CBJ,Columbus Blue Jackets,CBJ,1,BUF,2,2,4,19,1,6,5,5,10,32,4,10
2022-23,4/14/2023,202304140NSH,Nashville Predators,NSH,1,COL,3,4,7,18,21,20,4,6,10,34,12,12
2022-23,4/13/2023,202304130ANA,Anaheim Ducks,ANA,1,LAK,3,5,8,21,10,17,5,9,14,36,12,10
2022-23,4/13/2023,202304130ARI,Arizona Coyotes,ARI,1,VAN,4,7,11,28,25,16,5,10,15,23,20,11
2022-23,4/13/2023,202304130BUF,Buffalo Sabres,BUF,1,OTT,4,8,12,36,9,10,2,4,6,28,28,13
2022-23,4/13/2023,202304130CBJ,Columbus Blue Jackets,CBJ,1,PIT,3,3,6,30,8,3,2,4,6,36,14,11
2022-23,4/13/2023,202304130CHI,Chicago Blackhawks,CHI,1,PHI,2,7,9,32,19,8,5,6,11,32,15,17
2022-23,4/13/2023,202304130COL,Colorado Avalanche,COL,1,WPG,3,7,10,23,9,13,2,3,5,19,10,10
2022-23,4/13/2023,202304130DAL,Dallas Stars,DAL,1,STL,1,2,3,34,11,6,0,0,0,25,15,18
2022-23,4/13/2023,202304130EDM,Edmonton Oilers,EDM,1,SJS,5,8,13,36,15,10,2,4,6,29,7,13
2022-23,4/13/2023,202304130FLA,Carolina Hurricanes,CAR,0,FLA,6,6,12,36,14,15,4,5,9,34,31,13
2022-23,4/13/2023,202304130MTL,Boston Bruins,BOS,0,MTL,5,7,12,21,9,12,4,6,10,28,9,14
2022-23,4/13/2023,202304130NSH,Minnesota Wild,MIN,0,NSH,3,5,8,24,21,19,4,8,12,28,6,8
2022-23,4/13/2023,202304130NYR,New York Rangers,NYR,1,TOR,2,3,5,24,10,17,3,3,6,21,14,11
2022-23,4/13/2023,202304130SEA,Seattle Kraken,SEA,1,VEG,1,2,3,31,20,15,3,2,5,19,13,26
2022-23,4/13/2023,202304130TBL,Detroit Red Wings,DET,0,TBL,0,0,0,32,35,17,5,9,14,32,22,12
2022-23,4/13/2023,202304130WSH,New Jersey Devils,NJD,0,WSH,5,10,15,34,19,7,4,5,9,30,16,19
2022-23,4/13/2023,202304130ANA,Los Angeles Kings,LAK,0,ANA,5,9,14,36,12,10,3,5,8,21,10,17
2022-23,4/13/2023,202304130ARI,Vancouver Canucks,VAN,0,ARI,5,10,15,23,20,11,4,7,11,28,25,16
2022-23,4/13/2023,202304130BUF,Ottawa Senators,OTT,0,BUF,2,4,6,28,28,13,4,8,12,36,9,10
2022-23,4/13/2023,202304130CBJ,Pittsburgh Penguins,PIT,0,CBJ,2,4,6,36,14,11,3,3,6,30,8,3
2022-23,4/13/2023,202304130CHI,Philadelphia Flyers,PHI,0,CHI,5,6,11,32,15,17,2,7,9,32,19,8
2022-23,4/13/2023,202304130COL,Winnipeg Jets,WPG,0,COL,2,3,5,19,10,10,3,7,10,23,9,13
2022-23,4/13/2023,202304130DAL,St. Louis Blues,STL,0,DAL,0,0,0,25,15,18,1,2,3,34,11,6
2022-23,4/13/2023,202304130EDM,San Jose Sharks,SJS,0,EDM,2,4,6,29,7,13,5,8,13,36,15,10
2022-23,4/13/2023,202304130FLA,Florida Panthers,FLA,1,CAR,4,5,9,34,31,13,6,6,12,36,14,15
2022-23,4/13/2023,202304130MTL,Montreal Canadiens,MTL,1,BOS,4,6,10,28,9,14,5,7,12,21,9,12
2022-23,4/13/2023,202304130NSH,Nashville Predators,NSH,1,MIN,4,8,12,28,6,8,3,5,8,24,21,19
2022-23,4/13/2023,202304130NYR,Toronto Maple Leafs,TOR,0,NYR,3,3,6,21,14,11,2,3,5,24,10,17
2022-23,4/13/2023,202304130SEA,Vegas Golden Knights,VEG,0,SEA,3,2,5,19,13,26,1,2,3,31,20,15
2022-23,4/13/2023,202304130TBL,Tampa Bay Lightning,TBL,1,DET,5,9,14,32,22,12,0,0,0,32,35,17
2022-23,4/13/2023,202304130WSH,Washington Capitals,WSH,1,NJD,4,5,9,30,16,19,5,10,15,34,19,7
2022-23,4/12/2023,202304120CGY,Calgary Flames,CGY,1,SJS,3,4,7,45,12,13,1,0,1,23,14,15
2022-23,4/12/2023,202304120NYI,Montreal Canadiens,MTL,0,NYI,2,1,3,15,15,18,4,8,12,35,17,17
2022-23,4/12/2023,202304120STL,Dallas Stars,DAL,0,STL,5,10,15,37,16,10,2,3,5,18,14,21
2022-23,4/12/2023,202304120CGY,San Jose Sharks,SJS,0,CGY,1,0,1,23,14,15,3,4,7,45,12,13
2022-23,4/12/2023,202304120NYI,New York Islanders,NYI,1,MTL,4,8,12,35,17,17,2,1,3,15,15,18
2022-23,4/12/2023,202304120STL,St. Louis Blues,STL,1,DAL,2,3,5,18,14,21,5,10,15,37,16,10
2022-23,4/11/2023,202304110ANA,Anaheim Ducks,ANA,1,VAN,1,4,5,32,6,12,3,5,8,32,15,12
2022-23,4/11/2023,202304110BOS,Boston Bruins,BOS,1,WSH,5,6,11,40,19,7,2,2,4,27,22,15
2022-23,4/11/2023,202304110CAR,Carolina Hurricanes,CAR,1,DET,4,6,10,28,14,6,1,2,3,19,14,9
2022-23,4/11/2023,202304110COL,Colorado Avalanche,COL,1,EDM,1,0,1,26,12,14,2,4,6,40,25,14
2022-23,4/11/2023,202304110MIN,Minnesota Wild,MIN,1,WPG,1,2,3,34,18,14,3,6,9,19,17,21
2022-23,4/11/2023,202304110NJD,Buffalo Sabres,BUF,0,NJD,2,3,5,38,14,10,6,11,17,30,19,22
2022-23,4/11/2023,202304110PHI,Columbus Blue Jackets,CBJ,0,PHI,3,3,6,29,12,10,4,8,12,36,17,12
2022-23,4/11/2023,202304110PIT,Chicago Blackhawks,CHI,0,PIT,4,6,10,19,26,23,2,3,5,39,17,6
2022-23,4/11/2023,202304110TBL,Tampa Bay Lightning,TBL,1,TOR,3,4,7,48,29,6,4,7,11,24,23,17
2022-23,4/11/2023,202304110VEG,Seattle Kraken,SEA,0,VEG,1,1,2,21,37,18,4,8,12,36,29,16
2022-23,4/11/2023,202304110ANA,Vancouver Canucks,VAN,0,ANA,3,5,8,32,15,12,1,4,5,32,6,12
2022-23,4/11/2023,202304110BOS,Washington Capitals,WSH,0,BOS,2,2,4,27,22,15,5,6,11,40,19,7
2022-23,4/11/2023,202304110CAR,Detroit Red Wings,DET,0,CAR,1,2,3,19,14,9,4,6,10,28,14,6
2022-23,4/11/2023,202304110COL,Edmonton Oilers,EDM,0,COL,2,4,6,40,25,14,1,0,1,26,12,14
2022-23,4/11/2023,202304110MIN,Winnipeg Jets,WPG,0,MIN,3,6,9,19,17,21,1,2,3,34,18,14
2022-23,4/11/2023,202304110NJD,New Jersey Devils,NJD,1,BUF,6,11,17,30,19,22,2,3,5,38,14,10
2022-23,4/11/2023,202304110PHI,Philadelphia Flyers,PHI,1,CBJ,4,8,12,36,17,12,3,3,6,29,12,10
2022-23,4/11/2023,202304110PIT,Pittsburgh Penguins,PIT,1,CHI,2,3,5,39,17,6,4,6,10,19,26,23
2022-23,4/11/2023,202304110TBL,Toronto Maple Leafs,TOR,0,TBL,4,7,11,24,23,17,3,4,7,48,29,6
2022-23,4/11/2023,202304110VEG,Vegas Golden Knights,VEG,1,SEA,4,8,12,36,29,16,1,1,2,21,37,18
2022-23,4/10/2023,202304100ARI,Arizona Coyotes,ARI,1,SEA,1,1,2,23,25,12,4,5,9,36,17,9
2022-23,4/10/2023,202304100CGY,Calgary Flames,CGY,1,NSH,2,4,6,39,18,3,2,2,4,29,14,22
2022-23,4/10/2023,202304100CHI,Chicago Blackhawks,CHI,1,MIN,1,2,3,34,15,12,4,4,8,22,19,31
2022-23,4/10/2023,202304100DET,Dallas Stars,DAL,0,DET,6,12,18,22,10,11,1,1,2,17,12,11
2022-23,4/10/2023,202304100FLA,Florida Panthers,FLA,1,TOR,1,2,3,45,36,11,2,3,5,25,25,23
2022-23,4/10/2023,202304100LAK,Los Angeles Kings,LAK,1,VAN,3,4,7,28,19,15,0,0,0,20,28,14
2022-23,4/10/2023,202304100NYR,Buffalo Sabres,BUF,0,NYR,2,3,5,39,11,11,2,3,5,28,15,8
2022-23,4/10/2023,202304100OTT,Carolina Hurricanes,CAR,0,OTT,2,4,6,28,15,8,3,6,9,28,12,15
2022-23,4/10/2023,202304100WPG,San Jose Sharks,SJS,0,WPG,2,3,5,19,26,11,6,11,17,33,9,12
2022-23,4/10/2023,202304100WSH,New York Islanders,NYI,0,WSH,2,4,6,40,16,13,5,6,11,22,17,25
2022-23,4/10/2023,202304100ARI,Seattle Kraken,SEA,0,ARI,4,5,9,36,17,9,1,1,2,23,25,12
2022-23,4/10/2023,202304100CGY,Nashville Predators,NSH,0,CGY,2,2,4,29,14,22,2,4,6,39,18,3
2022-23,4/10/2023,202304100CHI,Minnesota Wild,MIN,0,CHI,4,4,8,22,19,31,1,2,3,34,15,12
2022-23,4/10/2023,202304100DET,Detroit Red Wings,DET,1,DAL,1,1,2,17,12,11,6,12,18,22,10,11
2022-23,4/10/2023,202304100FLA,Toronto Maple Leafs,TOR,0,FLA,2,3,5,25,25,23,1,2,3,45,36,11
2022-23,4/10/2023,202304100LAK,Vancouver Canucks,VAN,0,LAK,0,0,0,20,28,14,3,4,7,28,19,15
2022-23,4/10/2023,202304100NYR,New York Rangers,NYR,1,BUF,2,3,5,28,15,8,2,3,5,39,11,11
2022-23,4/10/2023,202304100OTT,Ottawa Senators,OTT,1,CAR,3,6,9,28,12,15,2,4,6,28,15,8
2022-23,4/10/2023,202304100WPG,Winnipeg Jets,WPG,1,SJS,6,11,17,33,9,12,2,3,5,19,26,11
2022-23,4/10/2023,202304100WSH,Washington Capitals,WSH,1,NYI,5,6,11,22,17,25,2,4,6,40,16,13
2022-23,4/9/2023,202304090ANA,Anaheim Ducks,ANA,1,COL,4,6,10,19,6,12,5,10,15,43,8,14
2022-23,4/9/2023,202304090PHI,Boston Bruins,BOS,0,PHI,5,7,12,32,20,7,2,3,5,33,14,10
2022-23,4/9/2023,202304090ANA,Colorado Avalanche,COL,0,ANA,5,10,15,43,8,14,4,6,10,19,6,12
2022-23,4/9/2023,202304090PHI,Philadelphia Flyers,PHI,1,BOS,2,3,5,33,14,10,5,7,12,32,20,7
2022-23,4/8/2023,202304080ARI,Anaheim Ducks,ANA,0,ARI,4,5,9,28,14,11,5,10,15,32,22,13
2022-23,4/8/2023,202304080BOS,Boston Bruins,BOS,1,NJD,2,4,6,36,26,8,1,2,3,30,32,16
2022-23,4/8/2023,202304080BUF,Buffalo Sabres,BUF,1,CAR,4,7,11,30,22,14,3,5,8,33,17,5
2022-23,4/8/2023,202304080CBJ,Columbus Blue Jackets,CBJ,1,NYR,0,0,0,16,15,17,4,7,11,28,16,14
2022-23,4/8/2023,202304080DAL,Dallas Stars,DAL,1,VEG,1,2,3,25,29,13,1,2,3,18,24,15
2022-23,4/8/2023,202304080DET,Detroit Red Wings,DET,1,PIT,1,2,3,18,18,13,5,6,11,26,8,16
2022-23,4/8/2023,202304080LAK,Colorado Avalanche,COL,0,LAK,1,5,6,19,21,18,3,6,9,41,19,16
2022-23,4/8/2023,202304080MIN,Minnesota Wild,MIN,1,STL,5,5,10,30,8,15,3,6,9,39,9,12
2022-23,4/8/2023,202304080NYI,New York Islanders,NYI,1,PHI,4,7,11,21,17,15,0,0,0,21,15,18
2022-23,4/8/2023,202304080OTT,Ottawa Senators,OTT,1,TBL,6,10,16,35,16,11,4,8,12,24,25,11
2022-23,4/8/2023,202304080SEA,Chicago Blackhawks,CHI,0,SEA,3,5,8,26,13,11,7,10,17,30,18,17
2022-23,4/8/2023,202304080SJS,Edmonton Oilers,EDM,0,SJS,6,10,16,34,18,16,1,1,2,21,15,8
2022-23,4/8/2023,202304080TOR,Montreal Canadiens,MTL,0,TOR,1,2,3,19,26,9,7,11,18,46,25,14
2022-23,4/8/2023,202304080VAN,Calgary Flames,CGY,0,VAN,2,3,5,41,27,12,2,3,5,30,23,14
2022-23,4/8/2023,202304080WPG,Nashville Predators,NSH,0,WPG,0,0,0,26,30,21,2,4,6,36,29,8
2022-23,4/8/2023,202304080WSH,Florida Panthers,FLA,0,WSH,4,6,10,37,9,12,2,4,6,24,21,22
2022-23,4/8/2023,202304080ARI,Arizona Coyotes,ARI,1,ANA,5,10,15,32,22,13,4,5,9,28,14,11
2022-23,4/8/2023,202304080BOS,New Jersey Devils,NJD,0,BOS,1,2,3,30,32,16,2,4,6,36,26,8
2022-23,4/8/2023,202304080BUF,Carolina Hurricanes,CAR,0,BUF,3,5,8,33,17,5,4,7,11,30,22,14
2022-23,4/8/2023,202304080CBJ,New York Rangers,NYR,0,CBJ,4,7,11,28,16,14,0,0,0,16,15,17
2022-23,4/8/2023,202304080DAL,Vegas Golden Knights,VEG,0,DAL,1,2,3,18,24,15,1,2,3,25,29,13
2022-23,4/8/2023,202304080DET,Pittsburgh Penguins,PIT,0,DET,5,6,11,26,8,16,1,2,3,18,18,13
2022-23,4/8/2023,202304080LAK,Los Angeles Kings,LAK,1,COL,3,6,9,41,19,16,1,5,6,19,21,18
2022-23,4/8/2023,202304080MIN,St. Louis Blues,STL,0,MIN,3,6,9,39,9,12,5,5,10,30,8,15
2022-23,4/8/2023,202304080NYI,Philadelphia Flyers,PHI,0,NYI,0,0,0,21,15,18,4,7,11,21,17,15
2022-23,4/8/2023,202304080OTT,Tampa Bay Lightning,TBL,0,OTT,4,8,12,24,25,11,6,10,16,35,16,11
2022-23,4/8/2023,202304080SEA,Seattle Kraken,SEA,1,CHI,7,10,17,30,18,17,3,5,8,26,13,11
2022-23,4/8/2023,202304080SJS,San Jose Sharks,SJS,1,EDM,1,1,2,21,15,8,6,10,16,34,18,16
2022-23,4/8/2023,202304080TOR,Toronto Maple Leafs,TOR,1,MTL,7,11,18,46,25,14,1,2,3,19,26,9
2022-23,4/8/2023,202304080VAN,Vancouver Canucks,VAN,1,CGY,2,3,5,30,23,14,2,3,5,41,27,12
2022-23,4/8/2023,202304080WPG,Winnipeg Jets,WPG,1,NSH,2,4,6,36,29,8,0,0,0,26,30,21
2022-23,4/8/2023,202304080WSH,Washington Capitals,WSH,1,FLA,2,4,6,24,21,22,4,6,10,37,9,12
2022-23,4/6/2023,202304060BOS,Boston Bruins,BOS,1,TOR,2,3,5,31,37,13,1,1,2,32,28,13
2022-23,4/6/2023,202304060DAL,Dallas Stars,DAL,1,PHI,4,7,11,30,18,10,1,2,3,23,19,17
2022-23,4/6/2023,202304060DET,Buffalo Sabres,BUF,0,DET,6,12,18,35,8,11,5,8,13,30,13,4
2022-23,4/6/2023,202304060FLA,Florida Panthers,FLA,1,OTT,7,12,19,28,23,22,2,3,5,53,21,10
2022-23,4/6/2023,202304060MTL,Montreal Canadiens,MTL,1,WSH,6,9,15,31,6,14,2,4,6,25,16,17
2022-23,4/6/2023,202304060NJD,Columbus Blue Jackets,CBJ,0,NJD,0,2,2,10,6,6,8,13,21,36,8,16
2022-23,4/6/2023,202304060NSH,Carolina Hurricanes,CAR,0,NSH,0,0,0,32,14,3,3,4,7,20,14,25
2022-23,4/6/2023,202304060NYI,New York Islanders,NYI,1,TBL,6,10,16,42,23,11,1,1,2,31,16,26
2022-23,4/6/2023,202304060PIT,Minnesota Wild,MIN,0,PIT,1,2,3,28,23,11,4,8,12,30,25,23
2022-23,4/6/2023,202304060SEA,Arizona Coyotes,ARI,0,SEA,1,3,4,22,8,7,4,5,9,33,15,13
2022-23,4/6/2023,202304060SJS,Colorado Avalanche,COL,0,SJS,6,11,17,29,15,17,2,4,6,22,24,11
2022-23,4/6/2023,202304060STL,New York Rangers,NYR,0,STL,2,4,6,24,9,12,3,4,7,21,15,18
2022-23,4/6/2023,202304060VAN,Chicago Blackhawks,CHI,0,VAN,0,0,0,32,33,8,2,6,8,26,35,11
2022-23,4/6/2023,202304060VEG,Los Angeles Kings,LAK,0,VEG,2,2,4,32,45,17,4,6,10,33,20,15
2022-23,4/6/2023,202304060BOS,Toronto Maple Leafs,TOR,0,BOS,1,1,2,32,28,13,2,3,5,31,37,13
2022-23,4/6/2023,202304060DAL,Philadelphia Flyers,PHI,0,DAL,1,2,3,23,19,17,4,7,11,30,18,10
2022-23,4/6/2023,202304060DET,Detroit Red Wings,DET,1,BUF,5,8,13,30,13,4,6,12,18,35,8,11
2022-23,4/6/2023,202304060FLA,Ottawa Senators,OTT,0,FLA,2,3,5,53,21,10,7,12,19,28,23,22
2022-23,4/6/2023,202304060MTL,Washington Capitals,WSH,0,MTL,2,4,6,25,16,17,6,9,15,31,6,14
2022-23,4/6/2023,202304060NJD,New Jersey Devils,NJD,1,CBJ,8,13,21,36,8,16,0,2,2,10,6,6
2022-23,4/6/2023,202304060NSH,Nashville Predators,NSH,1,CAR,3,4,7,20,14,25,0,0,0,32,14,3
2022-23,4/6/2023,202304060NYI,Tampa Bay Lightning,TBL,0,NYI,1,1,2,31,16,26,6,10,16,42,23,11
2022-23,4/6/2023,202304060PIT,Pittsburgh Penguins,PIT,1,MIN,4,8,12,30,25,23,1,2,3,28,23,11
2022-23,4/6/2023,202304060SEA,Seattle Kraken,SEA,1,ARI,4,5,9,33,15,13,1,3,4,22,8,7
2022-23,4/6/2023,202304060SJS,San Jose Sharks,SJS,1,COL,2,4,6,22,24,11,6,11,17,29,15,17
2022-23,4/6/2023,202304060STL,St. Louis Blues,STL,1,NYR,3,4,7,21,15,18,2,4,6,24,9,12
2022-23,4/6/2023,202304060VAN,Vancouver Canucks,VAN,1,CHI,2,6,8,26,35,11,0,0,0,32,33,8
2022-23,4/6/2023,202304060VEG,Vegas Golden Knights,VEG,1,LAK,4,6,10,33,20,15,2,2,4,32,45,17
2022-23,4/5/2023,202304050ANA,Anaheim Ducks,ANA,1,EDM,1,2,3,20,6,6,3,4,7,33,18,14
2022-23,4/5/2023,202304050NYR,New York Rangers,NYR,1,TBL,6,12,18,37,19,14,3,6,9,31,21,11
2022-23,4/5/2023,202304050WPG,Calgary Flames,CGY,0,WPG,3,5,8,31,30,13,1,2,3,34,24,6
2022-23,4/5/2023,202304050ANA,Edmonton Oilers,EDM,0,ANA,3,4,7,33,18,14,1,2,3,20,6,6
2022-23,4/5/2023,202304050NYR,Tampa Bay Lightning,TBL,0,NYR,3,6,9,31,21,11,6,12,18,37,19,14
2022-23,4/5/2023,202304050WPG,Winnipeg Jets,WPG,1,CGY,1,2,3,34,24,6,3,5,8,31,30,13
2022-23,4/4/2023,202304040CAR,Carolina Hurricanes,CAR,1,OTT,3,6,9,35,12,11,2,4,6,27,19,15
2022-23,4/4/2023,202304040CGY,Calgary Flames,CGY,1,CHI,3,4,7,33,14,8,3,3,6,22,23,23
2022-23,4/4/2023,202304040FLA,Buffalo Sabres,BUF,0,FLA,1,2,3,40,20,10,2,4,6,36,28,16
2022-23,4/4/2023,202304040LAK,Edmonton Oilers,EDM,0,LAK,3,5,8,33,39,9,1,1,2,21,23,17
2022-23,4/4/2023,202304040MTL,Detroit Red Wings,DET,0,MTL,4,8,12,18,7,5,0,0,0,23,10,14
2022-23,4/4/2023,202304040NJD,New Jersey Devils,NJD,1,PIT,5,10,15,37,11,20,1,2,3,22,17,15
2022-23,4/4/2023,202304040NSH,Nashville Predators,NSH,1,VEG,3,5,8,26,25,15,2,3,5,32,16,13
2022-23,4/4/2023,202304040SJS,Colorado Avalanche,COL,0,SJS,4,6,10,39,12,14,3,6,9,30,23,18
2022-23,4/4/2023,202304040STL,Philadelphia Flyers,PHI,0,STL,2,3,5,32,17,12,4,7,11,29,11,10
2022-23,4/4/2023,202304040TOR,Columbus Blue Jackets,CBJ,0,TOR,2,2,4,21,25,7,4,5,9,48,27,18
2022-23,4/4/2023,202304040VAN,Seattle Kraken,SEA,0,VAN,5,4,9,26,27,11,2,4,6,16,38,7
2022-23,4/4/2023,202304040CAR,Ottawa Senators,OTT,0,CAR,2,4,6,27,19,15,3,6,9,35,12,11
2022-23,4/4/2023,202304040CGY,Chicago Blackhawks,CHI,0,CGY,3,3,6,22,23,23,3,4,7,33,14,8
2022-23,4/4/2023,202304040FLA,Florida Panthers,FLA,1,BUF,2,4,6,36,28,16,1,2,3,40,20,10
2022-23,4/4/2023,202304040LAK,Los Angeles Kings,LAK,1,EDM,1,1,2,21,23,17,3,5,8,33,39,9
2022-23,4/4/2023,202304040MTL,Montreal Canadiens,MTL,1,DET,0,0,0,23,10,14,4,8,12,18,7,5
2022-23,4/4/2023,202304040NJD,Pittsburgh Penguins,PIT,0,NJD,1,2,3,22,17,15,5,10,15,37,11,20
2022-23,4/4/2023,202304040NSH,Vegas Golden Knights,VEG,0,NSH,2,3,5,32,16,13,3,5,8,26,25,15
2022-23,4/4/2023,202304040SJS,San Jose Sharks,SJS,1,COL,3,6,9,30,23,18,4,6,10,39,12,14
2022-23,4/4/2023,202304040STL,St. Louis Blues,STL,1,PHI,4,7,11,29,11,10,2,3,5,32,17,12
2022-23,4/4/2023,202304040TOR,Toronto Maple Leafs,TOR,1,CBJ,4,5,9,48,27,18,2,2,4,21,25,7
2022-23,4/4/2023,202304040VAN,Vancouver Canucks,VAN,1,SEA,2,4,6,16,38,7,5,4,9,26,27,11
2022-23,4/3/2023,202304030DAL,Dallas Stars,DAL,1,NSH,5,10,15,26,18,14,1,0,1,24,16,11
2022-23,4/3/2023,202304030MIN,Minnesota Wild,MIN,1,VEG,3,6,9,33,28,22,3,6,9,22,14,19
2022-23,4/3/2023,202304030SEA,Arizona Coyotes,ARI,0,SEA,1,2,3,19,14,10,8,14,22,32,22,16
2022-23,4/3/2023,202304030DAL,Nashville Predators,NSH,0,DAL,1,0,1,24,16,11,5,10,15,26,18,14
2022-23,4/3/2023,202304030MIN,Vegas Golden Knights,VEG,0,MIN,3,6,9,22,14,19,3,6,9,33,28,22
2022-23,4/3/2023,202304030SEA,Seattle Kraken,SEA,1,ARI,8,14,22,32,22,16,1,2,3,19,14,10
2022-23,4/2/2023,202304020CAR,Carolina Hurricanes,CAR,1,NYI,2,3,5,33,11,11,1,2,3,22,18,16
2022-23,4/2/2023,202304020CBJ,Columbus Blue Jackets,CBJ,1,OTT,4,4,8,17,10,7,2,3,5,25,19,11
2022-23,4/2/2023,202304020CGY,Anaheim Ducks,ANA,0,CGY,3,8,11,19,14,13,3,9,12,36,15,8
2022-23,4/2/2023,202304020PIT,Philadelphia Flyers,PHI,0,PIT,2,4,6,32,24,6,4,8,12,31,25,21
2022-23,4/2/2023,202304020STL,Boston Bruins,BOS,0,STL,3,5,8,31,14,20,3,6,9,34,16,11
2022-23,4/2/2023,202304020TOR,Detroit Red Wings,DET,0,TOR,5,7,12,20,22,16,2,3,5,44,27,10
2022-23,4/2/2023,202304020VAN,Los Angeles Kings,LAK,0,VAN,4,7,11,25,29,14,1,2,3,23,23,13
2022-23,4/2/2023,202304020WPG,New Jersey Devils,NJD,0,WPG,1,2,3,32,9,7,6,9,15,27,17,21
2022-23,4/2/2023,202304020WSH,New York Rangers,NYR,0,WSH,5,9,14,33,18,12,2,4,6,28,23,11
2022-23,4/2/2023,202304020CAR,New York Islanders,NYI,0,CAR,1,2,3,22,18,16,2,3,5,33,11,11
2022-23,4/2/2023,202304020CBJ,Ottawa Senators,OTT,0,CBJ,2,3,5,25,19,11,4,4,8,17,10,7
2022-23,4/2/2023,202304020CGY,Calgary Flames,CGY,1,ANA,3,9,12,36,15,8,3,8,11,19,14,13
2022-23,4/2/2023,202304020PIT,Pittsburgh Penguins,PIT,1,PHI,4,8,12,31,25,21,2,4,6,32,24,6
2022-23,4/2/2023,202304020STL,St. Louis Blues,STL,1,BOS,3,6,9,34,16,11,3,5,8,31,14,20
2022-23,4/2/2023,202304020TOR,Toronto Maple Leafs,TOR,1,DET,2,3,5,44,27,10,5,7,12,20,22,16
2022-23,4/2/2023,202304020VAN,Vancouver Canucks,VAN,1,LAK,1,2,3,23,23,13,4,7,11,25,29,14
2022-23,4/2/2023,202304020WPG,Winnipeg Jets,WPG,1,NJD,6,9,15,27,17,21,1,2,3,32,9,7
2022-23,4/2/2023,202304020WSH,Washington Capitals,WSH,1,NYR,2,4,6,28,23,11,5,9,14,33,18,12
2022-23,4/1/2023,202304010ARI,Arizona Coyotes,ARI,1,SJS,2,3,5,26,29,4,6,10,16,28,20,15
2022-23,4/1/2023,202304010CBJ,Columbus Blue Jackets,CBJ,1,FLA,0,0,0,19,9,6,6,13,19,47,18,11
2022-23,4/1/2023,202304010CHI,Chicago Blackhawks,CHI,1,NJD,3,5,8,15,21,22,6,11,17,40,14,7
2022-23,4/1/2023,202304010COL,Colorado Avalanche,COL,1,DAL,5,5,10,31,25,11,2,4,6,28,32,13
2022-23,4/1/2023,202304010EDM,Anaheim Ducks,ANA,0,EDM,0,0,0,30,19,6,6,7,13,45,16,9
2022-23,4/1/2023,202304010MTL,Carolina Hurricanes,CAR,0,MTL,2,5,7,45,9,6,0,0,0,12,16,16
2022-23,4/1/2023,202304010NSH,Nashville Predators,NSH,1,STL,6,7,13,31,16,14,1,1,2,21,15,12
2022-23,4/1/2023,202304010OTT,Ottawa Senators,OTT,1,TOR,0,0,0,30,35,10,3,3,6,20,30,22
2022-23,4/1/2023,202304010PHI,Buffalo Sabres,BUF,0,PHI,6,10,16,29,13,13,3,4,7,40,19,7
2022-23,4/1/2023,202304010PIT,Boston Bruins,BOS,0,PIT,4,6,10,34,29,15,3,4,7,23,33,18
2022-23,4/1/2023,202304010SEA,Los Angeles Kings,LAK,0,SEA,3,4,7,19,11,15,1,0,1,26,24,9
2022-23,4/1/2023,202304010TBL,New York Islanders,NYI,0,TBL,0,0,0,38,36,10,5,10,15,32,35,13
2022-23,4/1/2023,202304010VEG,Minnesota Wild,MIN,0,VEG,1,2,3,30,30,14,4,6,10,41,32,21
2022-23,4/1/2023,202304010ARI,San Jose Sharks,SJS,0,ARI,6,10,16,28,20,15,2,3,5,26,29,4
2022-23,4/1/2023,202304010CBJ,Florida Panthers,FLA,0,CBJ,6,13,19,47,18,11,0,0,0,19,9,6
2022-23,4/1/2023,202304010CHI,New Jersey Devils,NJD,0,CHI,6,11,17,40,14,7,3,5,8,15,21,22
2022-23,4/1/2023,202304010COL,Dallas Stars,DAL,0,COL,2,4,6,28,32,13,5,5,10,31,25,11
2022-23,4/1/2023,202304010EDM,Edmonton Oilers,EDM,1,ANA,6,7,13,45,16,9,0,0,0,30,19,6
2022-23,4/1/2023,202304010MTL,Montreal Canadiens,MTL,1,CAR,0,0,0,12,16,16,2,5,7,45,9,6
2022-23,4/1/2023,202304010NSH,St. Louis Blues,STL,0,NSH,1,1,2,21,15,12,6,7,13,31,16,14
2022-23,4/1/2023,202304010OTT,Toronto Maple Leafs,TOR,0,OTT,3,3,6,20,30,22,0,0,0,30,35,10
2022-23,4/1/2023,202304010PHI,Philadelphia Flyers,PHI,1,BUF,3,4,7,40,19,7,6,10,16,29,13,13
2022-23,4/1/2023,202304010PIT,Pittsburgh Penguins,PIT,1,BOS,3,4,7,23,33,18,4,6,10,34,29,15
2022-23,4/1/2023,202304010SEA,Seattle Kraken,SEA,1,LAK,1,0,1,26,24,9,3,4,7,19,11,15
2022-23,4/1/2023,202304010TBL,Tampa Bay Lightning,TBL,1,NYI,5,10,15,32,35,13,0,0,0,38,36,10
2022-23,4/1/2023,202304010VEG,Vegas Golden Knights,VEG,1,MIN,4,6,10,41,32,21,1,2,3,30,30,14
2022-23,3/31/2023,202303310ARI,Arizona Coyotes,ARI,1,DAL,2,4,6,16,18,7,5,9,14,31,17,14
2022-23,3/31/2023,202303310BUF,Buffalo Sabres,BUF,1,NYR,3,6,9,34,14,12,2,4,6,32,26,13
2022-23,3/31/2023,202303310VAN,Calgary Flames,CGY,0,VAN,5,9,14,38,29,12,3,5,8,18,27,20
2022-23,3/31/2023,202303310WPG,Detroit Red Wings,DET,0,WPG,2,3,5,21,13,21,6,12,18,27,7,14
2022-23,3/31/2023,202303310ARI,Dallas Stars,DAL,0,ARI,5,9,14,31,17,14,2,4,6,16,18,7
2022-23,3/31/2023,202303310BUF,New York Rangers,NYR,0,BUF,2,4,6,32,26,13,3,6,9,34,14,12
2022-23,3/31/2023,202303310VAN,Vancouver Canucks,VAN,1,CGY,3,5,8,18,27,20,5,9,14,38,29,12
2022-23,3/31/2023,202303310WPG,Winnipeg Jets,WPG,1,DET,6,12,18,27,7,14,2,3,5,21,13,21
2022-23,3/30/2023,202303300BOS,Boston Bruins,BOS,1,CBJ,2,4,6,23,28,16,1,1,2,19,12,6
2022-23,3/30/2023,202303300CHI,Chicago Blackhawks,CHI,1,STL,3,6,9,29,15,14,4,7,11,26,22,18
2022-23,3/30/2023,202303300DET,Carolina Hurricanes,CAR,0,DET,2,4,6,33,7,6,3,5,8,21,20,25
2022-23,3/30/2023,202303300EDM,Edmonton Oilers,EDM,1,LAK,2,2,4,37,34,15,0,0,0,42,18,9
2022-23,3/30/2023,202303300MTL,Florida Panthers,FLA,0,MTL,5,8,13,28,20,20,1,3,4,17,16,14
2022-23,3/30/2023,202303300NJD,New Jersey Devils,NJD,1,NYR,2,4,6,31,19,9,1,1,2,25,19,16
2022-23,3/30/2023,202303300OTT,Ottawa Senators,OTT,1,PHI,5,4,9,44,22,8,4,6,10,10,28,12
2022-23,3/30/2023,202303300PIT,Nashville Predators,NSH,0,PIT,0,0,0,27,36,15,2,4,6,43,39,13
2022-23,3/30/2023,202303300SEA,Anaheim Ducks,ANA,0,SEA,1,1,2,17,8,13,4,5,9,39,15,12
2022-23,3/30/2023,202303300SJS,San Jose Sharks,SJS,1,VEG,4,5,9,21,17,14,3,5,8,26,18,13
2022-23,3/30/2023,202303300TBL,Tampa Bay Lightning,TBL,1,WSH,5,6,11,34,37,11,1,2,3,31,36,16
2022-23,3/30/2023,202303300BOS,Columbus Blue Jackets,CBJ,0,BOS,1,1,2,19,12,6,2,4,6,23,28,16
2022-23,3/30/2023,202303300CHI,St. Louis Blues,STL,0,CHI,4,7,11,26,22,18,3,6,9,29,15,14
2022-23,3/30/2023,202303300DET,Detroit Red Wings,DET,1,CAR,3,5,8,21,20,25,2,4,6,33,7,6
2022-23,3/30/2023,202303300EDM,Los Angeles Kings,LAK,0,EDM,0,0,0,42,18,9,2,2,4,37,34,15
2022-23,3/30/2023,202303300MTL,Montreal Canadiens,MTL,1,FLA,1,3,4,17,16,14,5,8,13,28,20,20
2022-23,3/30/2023,202303300NJD,New York Rangers,NYR,0,NJD,1,1,2,25,19,16,2,4,6,31,19,9
2022-23,3/30/2023,202303300OTT,Philadelphia Flyers,PHI,0,OTT,4,6,10,10,28,12,5,4,9,44,22,8
2022-23,3/30/2023,202303300PIT,Pittsburgh Penguins,PIT,1,NSH,2,4,6,43,39,13,0,0,0,27,36,15
2022-23,3/30/2023,202303300SEA,Seattle Kraken,SEA,1,ANA,4,5,9,39,15,12,1,1,2,17,8,13
2022-23,3/30/2023,202303300SJS,Vegas Golden Knights,VEG,0,SJS,3,5,8,26,18,13,4,5,9,21,17,14
2022-23,3/30/2023,202303300TBL,Washington Capitals,WSH,0,TBL,1,2,3,31,36,16,5,6,11,34,37,11
2022-23,3/29/2023,202303290COL,Colorado Avalanche,COL,1,MIN,2,4,6,42,21,12,4,5,9,29,24,21
2022-23,3/29/2023,202303290TOR,Florida Panthers,FLA,0,TOR,3,5,8,27,22,11,2,2,4,40,11,12
2022-23,3/29/2023,202303290WSH,New York Islanders,NYI,0,WSH,1,2,3,29,24,15,1,0,1,26,27,26
2022-23,3/29/2023,202303290COL,Minnesota Wild,MIN,0,COL,4,5,9,29,24,21,2,4,6,42,21,12
2022-23,3/29/2023,202303290TOR,Toronto Maple Leafs,TOR,1,FLA,2,2,4,40,11,12,3,5,8,27,22,11
2022-23,3/29/2023,202303290WSH,Washington Capitals,WSH,1,NYI,1,0,1,26,27,26,1,2,3,29,24,15
2022-23,3/28/2023,202303280BOS,Boston Bruins,BOS,1,NSH,1,2,3,29,23,12,2,4,6,22,18,14
2022-23,3/28/2023,202303280CAR,Carolina Hurricanes,CAR,1,TBL,0,0,0,29,14,16,4,7,11,21,28,7
2022-23,3/28/2023,202303280CGY,Calgary Flames,CGY,1,LAK,2,3,5,31,26,13,1,2,3,32,21,15
2022-23,3/28/2023,202303280CHI,Chicago Blackhawks,CHI,1,DAL,1,2,3,17,17,11,4,8,12,33,8,8
2022-23,3/28/2023,202303280DET,Detroit Red Wings,DET,1,PIT,7,12,19,23,14,13,3,8,11,37,4,17
2022-23,3/28/2023,202303280NYR,Columbus Blue Jackets,CBJ,0,NYR,2,4,6,25,6,8,6,10,16,36,14,9
2022-23,3/28/2023,202303280PHI,Montreal Canadiens,MTL,0,PHI,2,2,4,27,16,16,3,3,6,22,15,16
2022-23,3/28/2023,202303280SJS,San Jose Sharks,SJS,1,WPG,2,6,8,23,9,13,0,0,0,40,15,15
2022-23,3/28/2023,202303280STL,St. Louis Blues,STL,1,VAN,6,9,15,31,24,17,5,9,14,37,15,9
2022-23,3/28/2023,202303280VEG,Edmonton Oilers,EDM,0,VEG,7,10,17,39,28,8,4,5,9,21,19,18
2022-23,3/28/2023,202303280BOS,Nashville Predators,NSH,0,BOS,2,4,6,22,18,14,1,2,3,29,23,12
2022-23,3/28/2023,202303280CAR,Tampa Bay Lightning,TBL,0,CAR,4,7,11,21,28,7,0,0,0,29,14,16
2022-23,3/28/2023,202303280CGY,Los Angeles Kings,LAK,0,CGY,1,2,3,32,21,15,2,3,5,31,26,13
2022-23,3/28/2023,202303280CHI,Dallas Stars,DAL,0,CHI,4,8,12,33,8,8,1,2,3,17,17,11
2022-23,3/28/2023,202303280DET,Pittsburgh Penguins,PIT,0,DET,3,8,11,37,4,17,7,12,19,23,14,13
2022-23,3/28/2023,202303280NYR,New York Rangers,NYR,1,CBJ,6,10,16,36,14,9,2,4,6,25,6,8
2022-23,3/28/2023,202303280PHI,Philadelphia Flyers,PHI,1,MTL,3,3,6,22,15,16,2,2,4,27,16,16
2022-23,3/28/2023,202303280SJS,Winnipeg Jets,WPG,0,SJS,0,0,0,40,15,15,2,6,8,23,9,13
2022-23,3/28/2023,202303280STL,Vancouver Canucks,VAN,0,STL,5,9,14,37,15,9,6,9,15,31,24,17
2022-23,3/28/2023,202303280VEG,Vegas Golden Knights,VEG,1,EDM,4,5,9,21,19,18,7,10,17,39,28,8
2022-23,3/27/2023,202303270ANA,Anaheim Ducks,ANA,1,COL,0,1,1,26,10,12,5,7,12,39,6,10
2022-23,3/27/2023,202303270ARI,Arizona Coyotes,ARI,1,EDM,4,8,12,30,29,17,5,7,12,29,22,10
2022-23,3/27/2023,202303270BUF,Buffalo Sabres,BUF,1,MTL,2,6,8,32,10,15,2,5,7,38,14,12
2022-23,3/27/2023,202303270MIN,Minnesota Wild,MIN,1,SEA,5,8,13,20,26,16,1,2,3,36,16,7
2022-23,3/27/2023,202303270NYI,New Jersey Devils,NJD,0,NYI,1,0,1,31,13,15,5,6,11,36,24,19
2022-23,3/27/2023,202303270OTT,Florida Panthers,FLA,0,OTT,2,3,5,32,30,8,4,6,10,25,20,16
2022-23,3/27/2023,202303270ANA,Colorado Avalanche,COL,0,ANA,5,7,12,39,6,10,0,1,1,26,10,12
2022-23,3/27/2023,202303270ARI,Edmonton Oilers,EDM,0,ARI,5,7,12,29,22,10,4,8,12,30,29,17
2022-23,3/27/2023,202303270BUF,Montreal Canadiens,MTL,0,BUF,2,5,7,38,14,12,2,6,8,32,10,15
2022-23,3/27/2023,202303270MIN,Seattle Kraken,SEA,0,MIN,1,2,3,36,16,7,5,8,13,20,26,16
2022-23,3/27/2023,202303270NYI,New York Islanders,NYI,1,NJD,5,6,11,36,24,19,1,0,1,31,13,15
2022-23,3/27/2023,202303270OTT,Ottawa Senators,OTT,1,FLA,4,6,10,25,20,16,2,3,5,32,30,8
2022-23,3/26/2023,202303260ARI,Arizona Coyotes,ARI,1,COL,3,4,7,30,25,13,3,4,7,32,10,19
2022-23,3/26/2023,202303260CAR,Boston Bruins,BOS,0,CAR,3,6,9,36,17,14,3,6,9,36,13,10
2022-23,3/26/2023,202303260CHI,Chicago Blackhawks,CHI,1,VAN,2,4,6,29,21,19,4,7,11,26,16,9
2022-23,3/26/2023,202303260LAK,Los Angeles Kings,LAK,1,STL,7,10,17,31,13,19,6,11,17,22,21,5
2022-23,3/26/2023,202303260NSH,Nashville Predators,NSH,1,TOR,2,3,5,23,21,15,3,6,9,33,21,11
2022-23,3/26/2023,202303260ARI,Colorado Avalanche,COL,0,ARI,3,4,7,32,10,19,3,4,7,30,25,13
2022-23,3/26/2023,202303260CAR,Carolina Hurricanes,CAR,1,BOS,3,6,9,36,13,10,3,6,9,36,17,14
2022-23,3/26/2023,202303260CHI,Vancouver Canucks,VAN,0,CHI,4,7,11,26,16,9,2,4,6,29,21,19
2022-23,3/26/2023,202303260LAK,St. Louis Blues,STL,0,LAK,6,11,17,22,21,5,7,10,17,31,13,19
2022-23,3/26/2023,202303260NSH,Toronto Maple Leafs,TOR,0,NSH,3,6,9,33,21,11,2,3,5,23,21,15
2022-23,3/25/2023,202303250ANA,Anaheim Ducks,ANA,1,STL,3,6,9,24,6,4,6,11,17,36,11,14
2022-23,3/25/2023,202303250BOS,Boston Bruins,BOS,1,TBL,1,4,5,30,24,9,1,2,3,27,35,18
2022-23,3/25/2023,202303250CAR,Carolina Hurricanes,CAR,1,TOR,5,9,14,28,14,16,3,4,7,44,16,10
2022-23,3/25/2023,202303250CGY,Calgary Flames,CGY,1,SJS,5,5,10,30,13,15,2,5,7,25,12,14
2022-23,3/25/2023,202303250DAL,Dallas Stars,DAL,1,VAN,1,2,3,26,13,7,2,5,7,19,14,19
2022-23,3/25/2023,202303250EDM,Edmonton Oilers,EDM,1,VEG,3,6,9,30,36,15,4,7,11,32,25,24
2022-23,3/25/2023,202303250FLA,Florida Panthers,FLA,1,NYR,3,4,7,32,17,11,4,5,9,39,18,23
2022-23,3/25/2023,202303250LAK,Los Angeles Kings,LAK,1,WPG,4,7,11,27,22,15,1,2,3,26,32,12
2022-23,3/25/2023,202303250MIN,Chicago Blackhawks,CHI,0,MIN,1,0,1,21,19,12,3,1,4,25,25,7
2022-23,3/25/2023,202303250MTL,Columbus Blue Jackets,CBJ,0,MTL,1,3,4,18,14,11,7,16,23,31,12,14
2022-23,3/25/2023,202303250NJD,New Jersey Devils,NJD,1,OTT,5,5,10,35,13,18,3,4,7,24,29,16
2022-23,3/25/2023,202303250NSH,Nashville Predators,NSH,1,SEA,2,4,6,15,31,10,7,9,16,39,22,12
2022-23,3/25/2023,202303250NYI,Buffalo Sabres,BUF,0,NYI,2,3,5,35,10,14,0,0,0,26,26,16
2022-23,3/25/2023,202303250PHI,Detroit Red Wings,DET,0,PHI,0,0,0,27,25,8,2,5,7,20,17,20
2022-23,3/25/2023,202303250PIT,Pittsburgh Penguins,PIT,1,WSH,4,4,8,39,23,14,3,5,8,34,31,14
2022-23,3/25/2023,202303250ANA,St. Louis Blues,STL,0,ANA,6,11,17,36,11,14,3,6,9,24,6,4
2022-23,3/25/2023,202303250BOS,Tampa Bay Lightning,TBL,0,BOS,1,2,3,27,35,18,1,4,5,30,24,9
2022-23,3/25/2023,202303250CAR,Toronto Maple Leafs,TOR,0,CAR,3,4,7,44,16,10,5,9,14,28,14,16
2022-23,3/25/2023,202303250CGY,San Jose Sharks,SJS,0,CGY,2,5,7,25,12,14,5,5,10,30,13,15
2022-23,3/25/2023,202303250DAL,Vancouver Canucks,VAN,0,DAL,2,5,7,19,14,19,1,2,3,26,13,7
2022-23,3/25/2023,202303250EDM,Vegas Golden Knights,VEG,0,EDM,4,7,11,32,25,24,3,6,9,30,36,15
2022-23,3/25/2023,202303250FLA,New York Rangers,NYR,0,FLA,4,5,9,39,18,23,3,4,7,32,17,11
2022-23,3/25/2023,202303250LAK,Winnipeg Jets,WPG,0,LAK,1,2,3,26,32,12,4,7,11,27,22,15
2022-23,3/25/2023,202303250MIN,Minnesota Wild,MIN,1,CHI,3,1,4,25,25,7,1,0,1,21,19,12
2022-23,3/25/2023,202303250MTL,Montreal Canadiens,MTL,1,CBJ,7,16,23,31,12,14,1,3,4,18,14,11
2022-23,3/25/2023,202303250NJD,Ottawa Senators,OTT,0,NJD,3,4,7,24,29,16,5,5,10,35,13,18
2022-23,3/25/2023,202303250NSH,Seattle Kraken,SEA,0,NSH,7,9,16,39,22,12,2,4,6,15,31,10
2022-23,3/25/2023,202303250NYI,New York Islanders,NYI,1,BUF,0,0,0,26,26,16,2,3,5,35,10,14
2022-23,3/25/2023,202303250PHI,Philadelphia Flyers,PHI,1,DET,2,5,7,20,17,20,0,0,0,27,25,8
2022-23,3/25/2023,202303250PIT,Washington Capitals,WSH,0,PIT,3,5,8,34,31,14,4,4,8,39,23,14
2022-23,3/24/2023,202303240BUF,Buffalo Sabres,BUF,1,NJD,5,9,14,26,5,18,4,8,12,31,18,4
2022-23,3/24/2023,202303240CBJ,Columbus Blue Jackets,CBJ,1,NYI,5,6,11,22,17,15,4,6,10,38,27,15
2022-23,3/24/2023,202303240COL,Arizona Coyotes,ARI,0,COL,1,2,3,16,18,18,3,6,9,27,18,5
2022-23,3/24/2023,202303240BUF,New Jersey Devils,NJD,0,BUF,4,8,12,31,18,4,5,9,14,26,5,18
2022-23,3/24/2023,202303240CBJ,New York Islanders,NYI,0,CBJ,4,6,10,38,27,15,5,6,11,22,17,15
2022-23,3/24/2023,202303240COL,Colorado Avalanche,COL,1,ARI,3,6,9,27,18,5,1,2,3,16,18,18
2022-23,3/23/2023,202303230ANA,Anaheim Ducks,ANA,1,WPG,2,3,5,18,7,9,3,6,9,30,7,10
2022-23,3/23/2023,202303230BOS,Boston Bruins,BOS,1,MTL,3,5,8,19,20,7,2,4,6,30,25,10
2022-23,3/23/2023,202303230CAR,Carolina Hurricanes,CAR,1,NYR,1,1,2,30,22,7,2,4,6,16,14,18
2022-23,3/23/2023,202303230CGY,Calgary Flames,CGY,1,VEG,2,3,5,42,22,13,3,5,8,30,12,31
2022-23,3/23/2023,202303230DAL,Dallas Stars,DAL,1,PIT,3,6,9,33,15,21,2,4,6,40,20,14
2022-23,3/23/2023,202303230DET,Detroit Red Wings,DET,1,STL,2,6,8,27,14,10,4,7,11,22,19,18
2022-23,3/23/2023,202303230FLA,Florida Panthers,FLA,1,TOR,2,4,6,34,26,17,6,10,16,27,18,12
2022-23,3/23/2023,202303230NSH,Nashville Predators,NSH,1,SEA,1,2,3,23,30,11,1,2,3,27,29,16
2022-23,3/23/2023,202303230OTT,Ottawa Senators,OTT,1,TBL,6,11,17,32,17,21,2,4,6,29,27,9
2022-23,3/23/2023,202303230PHI,Minnesota Wild,MIN,0,PHI,4,8,12,24,30,18,4,8,12,32,19,9
2022-23,3/23/2023,202303230VAN,San Jose Sharks,SJS,0,VAN,1,3,4,15,27,15,6,11,17,19,26,6
2022-23,3/23/2023,202303230WSH,Chicago Blackhawks,CHI,0,WSH,1,2,3,25,14,11,6,7,13,28,13,14
2022-23,3/23/2023,202303230ANA,Winnipeg Jets,WPG,0,ANA,3,6,9,30,7,10,2,3,5,18,7,9
2022-23,3/23/2023,202303230BOS,Montreal Canadiens,MTL,0,BOS,2,4,6,30,25,10,3,5,8,19,20,7
2022-23,3/23/2023,202303230CAR,New York Rangers,NYR,0,CAR,2,4,6,16,14,18,1,1,2,30,22,7
2022-23,3/23/2023,202303230CGY,Vegas Golden Knights,VEG,0,CGY,3,5,8,30,12,31,2,3,5,42,22,13
2022-23,3/23/2023,202303230DAL,Pittsburgh Penguins,PIT,0,DAL,2,4,6,40,20,14,3,6,9,33,15,21
2022-23,3/23/2023,202303230DET,St. Louis Blues,STL,0,DET,4,7,11,22,19,18,2,6,8,27,14,10
2022-23,3/23/2023,202303230FLA,Toronto Maple Leafs,TOR,0,FLA,6,10,16,27,18,12,2,4,6,34,26,17
2022-23,3/23/2023,202303230NSH,Seattle Kraken,SEA,0,NSH,1,2,3,27,29,16,1,2,3,23,30,11
2022-23,3/23/2023,202303230OTT,Tampa Bay Lightning,TBL,0,OTT,2,4,6,29,27,9,6,11,17,32,17,21
2022-23,3/23/2023,202303230PHI,Philadelphia Flyers,PHI,1,MIN,4,8,12,32,19,9,4,8,12,24,30,18
2022-23,3/23/2023,202303230VAN,Vancouver Canucks,VAN,1,SJS,6,11,17,19,26,6,1,3,4,15,27,15
2022-23,3/23/2023,202303230WSH,Washington Capitals,WSH,1,CHI,6,7,13,28,13,14,1,2,3,25,14,11
2022-23,3/22/2023,202303220COL,Colorado Avalanche,COL,1,PIT,2,3,5,26,14,12,5,7,12,43,7,15
2022-23,3/22/2023,202303220EDM,Arizona Coyotes,ARI,0,EDM,3,5,8,17,27,9,4,6,10,31,25,8
2022-23,3/22/2023,202303220COL,Pittsburgh Penguins,PIT,0,COL,5,7,12,43,7,15,2,3,5,26,14,12
2022-23,3/22/2023,202303220EDM,Edmonton Oilers,EDM,1,ARI,4,6,10,31,25,8,3,5,8,17,27,9
2022-23,3/21/2023,202303210ANA,Anaheim Ducks,ANA,1,CGY,1,2,3,19,7,5,4,9,13,42,10,9
2022-23,3/21/2023,202303210BOS,Boston Bruins,BOS,1,OTT,1,3,4,32,22,14,0,1,1,36,25,18
2022-23,3/21/2023,202303210BUF,Buffalo Sabres,BUF,1,NSH,3,5,8,31,14,9,7,9,16,26,16,8
2022-23,3/21/2023,202303210DAL,Dallas Stars,DAL,1,SEA,4,8,12,29,20,10,5,10,15,26,9,16
2022-23,3/21/2023,202303210MTL,Montreal Canadiens,MTL,1,TBL,3,5,8,19,19,19,2,4,6,33,16,8
2022-23,3/21/2023,202303210NJD,Minnesota Wild,MIN,0,NJD,2,2,4,29,18,22,1,2,3,48,11,16
2022-23,3/21/2023,202303210NYI,New York Islanders,NYI,1,TOR,7,7,14,29,36,19,2,4,6,27,15,9
2022-23,3/21/2023,202303210NYR,Carolina Hurricanes,CAR,0,NYR,3,5,8,37,8,7,2,4,6,31,17,14
2022-23,3/21/2023,202303210PHI,Florida Panthers,FLA,0,PHI,3,6,9,42,19,6,6,10,16,21,19,19
2022-23,3/21/2023,202303210STL,Detroit Red Wings,DET,0,STL,1,4,5,26,13,12,2,2,4,22,19,15
2022-23,3/21/2023,202303210VAN,Vancouver Canucks,VAN,1,VEG,3,4,7,25,30,11,3,5,8,26,17,12
2022-23,3/21/2023,202303210WPG,Arizona Coyotes,ARI,0,WPG,1,2,3,28,15,11,2,2,4,24,23,10
2022-23,3/21/2023,202303210WSH,Columbus Blue Jackets,CBJ,0,WSH,7,11,18,30,11,15,6,10,16,32,9,15
2022-23,3/21/2023,202303210ANA,Calgary Flames,CGY,0,ANA,4,9,13,42,10,9,1,2,3,19,7,5
2022-23,3/21/2023,202303210BOS,Ottawa Senators,OTT,0,BOS,0,1,1,36,25,18,1,3,4,32,22,14
2022-23,3/21/2023,202303210BUF,Nashville Predators,NSH,0,BUF,7,9,16,26,16,8,3,5,8,31,14,9
2022-23,3/21/2023,202303210DAL,Seattle Kraken,SEA,0,DAL,5,10,15,26,9,16,4,8,12,29,20,10
2022-23,3/21/2023,202303210MTL,Tampa Bay Lightning,TBL,0,MTL,2,4,6,33,16,8,3,5,8,19,19,19
2022-23,3/21/2023,202303210NJD,New Jersey Devils,NJD,1,MIN,1,2,3,48,11,16,2,2,4,29,18,22
2022-23,3/21/2023,202303210NYI,Toronto Maple Leafs,TOR,0,NYI,2,4,6,27,15,9,7,7,14,29,36,19
2022-23,3/21/2023,202303210NYR,New York Rangers,NYR,1,CAR,2,4,6,31,17,14,3,5,8,37,8,7
2022-23,3/21/2023,202303210PHI,Philadelphia Flyers,PHI,1,FLA,6,10,16,21,19,19,3,6,9,42,19,6
2022-23,3/21/2023,202303210STL,St. Louis Blues,STL,1,DET,2,2,4,22,19,15,1,4,5,26,13,12
2022-23,3/21/2023,202303210VAN,Vegas Golden Knights,VEG,0,VAN,3,5,8,26,17,12,3,4,7,25,30,11
2022-23,3/21/2023,202303210WPG,Winnipeg Jets,WPG,1,ARI,2,2,4,24,23,10,1,2,3,28,15,11
2022-23,3/21/2023,202303210WSH,Washington Capitals,WSH,1,CBJ,6,10,16,32,9,15,7,11,18,30,11,15
2022-23,3/20/2023,202303200COL,Chicago Blackhawks,CHI,0,COL,0,0,0,24,21,12,3,7,10,24,12,13
2022-23,3/20/2023,202303200DET,Detroit Red Wings,DET,1,FLA,2,4,6,21,19,11,4,8,12,23,19,8
2022-23,3/20/2023,202303200EDM,Edmonton Oilers,EDM,1,SJS,5,10,15,52,23,11,4,6,10,29,26,14
2022-23,3/20/2023,202303200LAK,Calgary Flames,CGY,0,LAK,2,4,6,18,26,12,8,14,22,38,23,13
2022-23,3/20/2023,202303200PIT,Ottawa Senators,OTT,0,PIT,2,4,6,21,32,25,1,2,3,46,28,14
2022-23,3/20/2023,202303200COL,Colorado Avalanche,COL,1,CHI,3,7,10,24,12,13,0,0,0,24,21,12
2022-23,3/20/2023,202303200DET,Florida Panthers,FLA,0,DET,4,8,12,23,19,8,2,4,6,21,19,11
2022-23,3/20/2023,202303200EDM,San Jose Sharks,SJS,0,EDM,4,6,10,29,26,14,5,10,15,52,23,11
2022-23,3/20/2023,202303200LAK,Los Angeles Kings,LAK,1,CGY,8,14,22,38,23,13,2,4,6,18,26,12
2022-23,3/20/2023,202303200PIT,Pittsburgh Penguins,PIT,1,OTT,1,2,3,46,28,14,2,4,6,21,32,25
2022-23,3/19/2023,202303190ANA,Anaheim Ducks,ANA,1,VAN,1,1,2,16,9,7,2,4,6,37,13,11
2022-23,3/19/2023,202303190BUF,Boston Bruins,BOS,0,BUF,6,11,17,21,14,8,0,0,0,25,17,4
2022-23,3/19/2023,202303190MIN,Minnesota Wild,MIN,1,WSH,5,7,12,40,13,11,3,5,8,34,27,9
2022-23,3/19/2023,202303190NYR,Nashville Predators,NSH,0,NYR,0,0,0,21,19,9,7,12,19,34,10,16
2022-23,3/19/2023,202303190STL,St. Louis Blues,STL,1,WPG,3,3,6,16,15,15,0,0,0,33,12,7
2022-23,3/19/2023,202303190TBL,New Jersey Devils,NJD,0,TBL,5,8,13,39,13,16,2,3,5,24,22,17
2022-23,3/19/2023,202303190VEG,Columbus Blue Jackets,CBJ,0,VEG,2,4,6,37,30,12,6,12,18,40,17,18
2022-23,3/19/2023,202303190ANA,Vancouver Canucks,VAN,0,ANA,2,4,6,37,13,11,1,1,2,16,9,7
2022-23,3/19/2023,202303190BUF,Buffalo Sabres,BUF,1,BOS,0,0,0,25,17,4,6,11,17,21,14,8
2022-23,3/19/2023,202303190MIN,Washington Capitals,WSH,0,MIN,3,5,8,34,27,9,5,7,12,40,13,11
2022-23,3/19/2023,202303190NYR,New York Rangers,NYR,1,NSH,7,12,19,34,10,16,0,0,0,21,19,9
2022-23,3/19/2023,202303190STL,Winnipeg Jets,WPG,0,STL,0,0,0,33,12,7,3,3,6,16,15,15
2022-23,3/19/2023,202303190TBL,Tampa Bay Lightning,TBL,1,NJD,2,3,5,24,22,17,5,8,13,39,13,16
2022-23,3/19/2023,202303190VEG,Vegas Golden Knights,VEG,1,CBJ,6,12,18,40,17,18,2,4,6,37,30,12
2022-23,3/18/2023,202303180ARI,Arizona Coyotes,ARI,1,CHI,4,8,12,19,23,14,2,2,4,30,19,8
2022-23,3/18/2023,202303180CGY,Calgary Flames,CGY,1,DAL,4,9,13,37,22,13,6,11,17,26,24,14
2022-23,3/18/2023,202303180DET,Colorado Avalanche,COL,0,DET,5,9,14,20,10,14,1,1,2,32,17,10
2022-23,3/18/2023,202303180FLA,Florida Panthers,FLA,1,NJD,4,7,11,41,39,6,2,3,5,35,20,16
2022-23,3/18/2023,202303180LAK,Los Angeles Kings,LAK,1,VAN,1,3,4,39,16,11,2,4,6,15,30,14
2022-23,3/18/2023,202303180MIN,Boston Bruins,BOS,0,MIN,3,7,10,31,28,9,2,4,6,31,16,9
2022-23,3/18/2023,202303180NSH,Nashville Predators,NSH,1,WPG,2,4,6,19,21,18,3,6,9,32,36,14
2022-23,3/18/2023,202303180NYR,New York Rangers,NYR,1,PIT,6,11,17,23,9,17,0,0,0,32,13,11
2022-23,3/18/2023,202303180OTT,Ottawa Senators,OTT,1,TOR,4,7,11,49,30,15,4,8,12,29,22,20
2022-23,3/18/2023,202303180PHI,Carolina Hurricanes,CAR,0,PHI,5,6,11,33,18,4,4,7,11,33,23,18
2022-23,3/18/2023,202303180SEA,Edmonton Oilers,EDM,0,SEA,6,12,18,23,16,11,4,8,12,37,24,8
2022-23,3/18/2023,202303180SJS,New York Islanders,NYI,0,SJS,4,7,11,33,15,19,1,2,3,29,22,13
2022-23,3/18/2023,202303180TBL,Montreal Canadiens,MTL,0,TBL,3,6,9,19,31,17,5,8,13,41,20,7
2022-23,3/18/2023,202303180ARI,Chicago Blackhawks,CHI,0,ARI,2,2,4,30,19,8,4,8,12,19,23,14
2022-23,3/18/2023,202303180CGY,Dallas Stars,DAL,0,CGY,6,11,17,26,24,14,4,9,13,37,22,13
2022-23,3/18/2023,202303180DET,Detroit Red Wings,DET,1,COL,1,1,2,32,17,10,5,9,14,20,10,14
2022-23,3/18/2023,202303180FLA,New Jersey Devils,NJD,0,FLA,2,3,5,35,20,16,4,7,11,41,39,6
2022-23,3/18/2023,202303180LAK,Vancouver Canucks,VAN,0,LAK,2,4,6,15,30,14,1,3,4,39,16,11
2022-23,3/18/2023,202303180MIN,Minnesota Wild,MIN,1,BOS,2,4,6,31,16,9,3,7,10,31,28,9
2022-23,3/18/2023,202303180NSH,Winnipeg Jets,WPG,0,NSH,3,6,9,32,36,14,2,4,6,19,21,18
2022-23,3/18/2023,202303180NYR,Pittsburgh Penguins,PIT,0,NYR,0,0,0,32,13,11,6,11,17,23,9,17
2022-23,3/18/2023,202303180OTT,Toronto Maple Leafs,TOR,0,OTT,4,8,12,29,22,20,4,7,11,49,30,15
2022-23,3/18/2023,202303180PHI,Philadelphia Flyers,PHI,1,CAR,4,7,11,33,23,18,5,6,11,33,18,4
2022-23,3/18/2023,202303180SEA,Seattle Kraken,SEA,1,EDM,4,8,12,37,24,8,6,12,18,23,16,11
2022-23,3/18/2023,202303180SJS,San Jose Sharks,SJS,1,NYI,1,2,3,29,22,13,4,7,11,33,15,19
2022-23,3/18/2023,202303180TBL,Tampa Bay Lightning,TBL,1,MTL,5,8,13,41,20,7,3,6,9,19,31,17
2022-23,3/17/2023,202303170ANA,Anaheim Ducks,ANA,1,CBJ,5,6,11,34,8,15,4,6,10,39,9,6
2022-23,3/17/2023,202303170PHI,Buffalo Sabres,BUF,0,PHI,2,4,6,37,22,12,5,9,14,19,24,14
2022-23,3/17/2023,202303170TOR,Carolina Hurricanes,CAR,0,TOR,2,4,6,32,18,8,5,9,14,24,26,22
2022-23,3/17/2023,202303170WSH,St. Louis Blues,STL,0,WSH,5,9,14,21,15,23,2,4,6,32,18,6
2022-23,3/17/2023,202303170ANA,Columbus Blue Jackets,CBJ,0,ANA,4,6,10,39,9,6,5,6,11,34,8,15
2022-23,3/17/2023,202303170PHI,Philadelphia Flyers,PHI,1,BUF,5,9,14,19,24,14,2,4,6,37,22,12
2022-23,3/17/2023,202303170TOR,Toronto Maple Leafs,TOR,1,CAR,5,9,14,24,26,22,2,4,6,32,18,8
2022-23,3/17/2023,202303170WSH,Washington Capitals,WSH,1,STL,2,4,6,32,18,6,5,9,14,21,15,23
2022-23,3/16/2023,202303160ARI,Arizona Coyotes,ARI,1,VAN,3,5,8,24,17,9,2,4,6,26,18,10
2022-23,3/16/2023,202303160EDM,Dallas Stars,DAL,0,EDM,1,2,3,26,27,11,4,6,10,30,27,14
2022-23,3/16/2023,202303160FLA,Florida Panthers,FLA,1,MTL,9,12,21,42,24,4,5,8,13,28,26,14
2022-23,3/16/2023,202303160LAK,Columbus Blue Jackets,CBJ,0,LAK,1,0,1,29,23,13,4,6,10,34,9,12
2022-23,3/16/2023,202303160NJD,New Jersey Devils,NJD,1,TBL,3,6,9,35,22,18,3,6,9,24,16,19
2022-23,3/16/2023,202303160NSH,Chicago Blackhawks,CHI,0,NSH,2,2,4,21,26,16,1,2,3,35,32,15
2022-23,3/16/2023,202303160NYR,New York Rangers,NYR,1,PIT,4,6,10,33,20,16,2,3,5,30,19,16
2022-23,3/16/2023,202303160OTT,Colorado Avalanche,COL,0,OTT,5,7,12,29,15,17,4,8,12,34,26,15
2022-23,3/16/2023,202303160SJS,Seattle Kraken,SEA,0,SJS,2,4,6,32,17,18,1,0,1,32,19,14
2022-23,3/16/2023,202303160VEG,Calgary Flames,CGY,0,VEG,7,11,18,28,30,17,2,4,6,19,23,16
2022-23,3/16/2023,202303160WPG,Boston Bruins,BOS,0,WPG,3,5,8,21,20,19,0,0,0,35,24,15
2022-23,3/16/2023,202303160ARI,Vancouver Canucks,VAN,0,ARI,2,4,6,26,18,10,3,5,8,24,17,9
2022-23,3/16/2023,202303160EDM,Edmonton Oilers,EDM,1,DAL,4,6,10,30,27,14,1,2,3,26,27,11
2022-23,3/16/2023,202303160FLA,Montreal Canadiens,MTL,0,FLA,5,8,13,28,26,14,9,12,21,42,24,4
2022-23,3/16/2023,202303160LAK,Los Angeles Kings,LAK,1,CBJ,4,6,10,34,9,12,1,0,1,29,23,13
2022-23,3/16/2023,202303160NJD,Tampa Bay Lightning,TBL,0,NJD,3,6,9,24,16,19,3,6,9,35,22,18
2022-23,3/16/2023,202303160NSH,Nashville Predators,NSH,1,CHI,1,2,3,35,32,15,2,2,4,21,26,16
2022-23,3/16/2023,202303160NYR,Pittsburgh Penguins,PIT,0,NYR,2,3,5,30,19,16,4,6,10,33,20,16
2022-23,3/16/2023,202303160OTT,Ottawa Senators,OTT,1,COL,4,8,12,34,26,15,5,7,12,29,15,17
2022-23,3/16/2023,202303160SJS,San Jose Sharks,SJS,1,SEA,1,0,1,32,19,14,2,4,6,32,17,18
2022-23,3/16/2023,202303160VEG,Vegas Golden Knights,VEG,1,CGY,2,4,6,19,23,16,7,11,18,28,30,17
2022-23,3/16/2023,202303160WPG,Winnipeg Jets,WPG,1,BOS,0,0,0,35,24,15,3,5,8,21,20,19
2022-23,3/15/2023,202303150ANA,Anaheim Ducks,ANA,1,NYI,3,6,9,19,13,17,6,10,16,33,15,10
2022-23,3/15/2023,202303150STL,Minnesota Wild,MIN,0,STL,8,13,21,35,15,10,5,9,14,36,21,8
2022-23,3/15/2023,202303150TOR,Colorado Avalanche,COL,0,TOR,1,2,3,26,19,12,1,2,3,18,21,22
2022-23,3/15/2023,202303150WSH,Buffalo Sabres,BUF,0,WSH,4,4,8,27,8,19,4,7,11,38,30,12
2022-23,3/15/2023,202303150ANA,New York Islanders,NYI,0,ANA,6,10,16,33,15,10,3,6,9,19,13,17
2022-23,3/15/2023,202303150STL,St. Louis Blues,STL,1,MIN,5,9,14,36,21,8,8,13,21,35,15,10
2022-23,3/15/2023,202303150TOR,Toronto Maple Leafs,TOR,1,COL,1,2,3,18,21,22,1,2,3,26,19,12
2022-23,3/15/2023,202303150WSH,Washington Capitals,WSH,1,BUF,4,7,11,38,30,12,4,4,8,27,8,19
2022-23,3/14/2023,202303140ARI,Arizona Coyotes,ARI,1,CGY,4,7,11,20,36,13,3,5,8,45,39,10
2022-23,3/14/2023,202303140CAR,Carolina Hurricanes,CAR,1,WPG,5,6,11,25,15,9,3,4,7,22,19,13
2022-23,3/14/2023,202303140CHI,Boston Bruins,BOS,0,CHI,3,5,8,36,19,9,6,9,15,27,31,10
2022-23,3/14/2023,202303140EDM,Edmonton Oilers,EDM,1,OTT,6,10,16,33,23,7,3,5,8,31,17,14
2022-23,3/14/2023,202303140LAK,Los Angeles Kings,LAK,1,NYI,5,10,15,37,13,18,2,3,5,27,30,13
2022-23,3/14/2023,202303140NJD,New Jersey Devils,NJD,1,TBL,1,2,3,23,13,17,4,6,10,30,12,19
2022-23,3/14/2023,202303140NSH,Detroit Red Wings,DET,0,NSH,0,2,2,25,19,12,2,4,6,15,16,16
2022-23,3/14/2023,202303140NYR,New York Rangers,NYR,1,WSH,5,7,12,36,27,20,2,5,7,30,13,11
2022-23,3/14/2023,202303140PHI,Philadelphia Flyers,PHI,1,VEG,3,2,5,29,19,8,5,7,12,29,9,18
2022-23,3/14/2023,202303140PIT,Montreal Canadiens,MTL,0,PIT,6,9,15,21,31,21,4,8,12,41,21,14
2022-23,3/14/2023,202303140SJS,Columbus Blue Jackets,CBJ,0,SJS,6,7,13,46,12,15,5,10,15,29,18,17
2022-23,3/14/2023,202303140VAN,Dallas Stars,DAL,0,VAN,2,3,5,27,26,10,4,8,12,16,20,10
2022-23,3/14/2023,202303140ARI,Calgary Flames,CGY,0,ARI,3,5,8,45,39,10,4,7,11,20,36,13
2022-23,3/14/2023,202303140CAR,Winnipeg Jets,WPG,0,CAR,3,4,7,22,19,13,5,6,11,25,15,9
2022-23,3/14/2023,202303140CHI,Chicago Blackhawks,CHI,1,BOS,6,9,15,27,31,10,3,5,8,36,19,9
2022-23,3/14/2023,202303140EDM,Ottawa Senators,OTT,0,EDM,3,5,8,31,17,14,6,10,16,33,23,7
2022-23,3/14/2023,202303140LAK,New York Islanders,NYI,0,LAK,2,3,5,27,30,13,5,10,15,37,13,18
2022-23,3/14/2023,202303140NJD,Tampa Bay Lightning,TBL,0,NJD,4,6,10,30,12,19,1,2,3,23,13,17
2022-23,3/14/2023,202303140NSH,Nashville Predators,NSH,1,DET,2,4,6,15,16,16,0,2,2,25,19,12
2022-23,3/14/2023,202303140NYR,Washington Capitals,WSH,0,NYR,2,5,7,30,13,11,5,7,12,36,27,20
2022-23,3/14/2023,202303140PHI,Vegas Golden Knights,VEG,0,PHI,5,7,12,29,9,18,3,2,5,29,19,8
2022-23,3/14/2023,202303140PIT,Pittsburgh Penguins,PIT,1,MTL,4,8,12,41,21,14,6,9,15,21,31,21
2022-23,3/14/2023,202303140SJS,San Jose Sharks,SJS,1,CBJ,5,10,15,29,18,17,6,7,13,46,12,15
2022-23,3/14/2023,202303140VAN,Vancouver Canucks,VAN,1,DAL,4,8,12,16,20,10,2,3,5,27,26,10
2022-23,3/13/2023,202303130MTL,Colorado Avalanche,COL,0,MTL,8,15,23,29,5,12,4,6,10,18,20,19
2022-23,3/13/2023,202303130SEA,Dallas Stars,DAL,0,SEA,5,10,15,32,5,12,2,2,4,28,17,13
2022-23,3/13/2023,202303130TOR,Buffalo Sabres,BUF,0,TOR,4,7,11,29,24,10,3,5,8,28,30,15
2022-23,3/13/2023,202303130MTL,Montreal Canadiens,MTL,1,COL,4,6,10,18,20,19,8,15,23,29,5,12
2022-23,3/13/2023,202303130SEA,Seattle Kraken,SEA,1,DAL,2,2,4,28,17,13,5,10,15,32,5,12
2022-23,3/13/2023,202303130TOR,Toronto Maple Leafs,TOR,1,BUF,3,5,8,28,30,15,4,7,11,29,24,10
2022-23,3/12/2023,202303120ANA,Anaheim Ducks,ANA,1,NSH,4,6,10,35,11,8,5,8,13,36,12,8
2022-23,3/12/2023,202303120ARI,Arizona Coyotes,ARI,1,MIN,4,8,12,19,27,17,4,7,11,34,33,10
2022-23,3/12/2023,202303120CGY,Calgary Flames,CGY,1,OTT,5,9,14,39,23,11,1,0,1,31,25,27
2022-23,3/12/2023,202303120DET,Boston Bruins,BOS,0,DET,3,5,8,28,14,7,4,8,12,24,11,27
2022-23,3/12/2023,202303120NJD,Carolina Hurricanes,CAR,0,NJD,0,0,0,30,11,13,3,3,6,23,14,17
2022-23,3/12/2023,202303120PIT,New York Rangers,NYR,0,PIT,2,3,5,28,42,15,3,5,8,35,42,21
2022-23,3/12/2023,202303120STL,St. Louis Blues,STL,1,VEG,3,6,9,33,25,10,5,9,14,29,10,15
2022-23,3/12/2023,202303120TBL,Tampa Bay Lightning,TBL,1,WPG,2,3,5,35,33,8,3,5,8,21,41,12
2022-23,3/12/2023,202303120ANA,Nashville Predators,NSH,0,ANA,5,8,13,36,12,8,4,6,10,35,11,8
2022-23,3/12/2023,202303120ARI,Minnesota Wild,MIN,0,ARI,4,7,11,34,33,10,4,8,12,19,27,17
2022-23,3/12/2023,202303120CGY,Ottawa Senators,OTT,0,CGY,1,0,1,31,25,27,5,9,14,39,23,11
2022-23,3/12/2023,202303120DET,Detroit Red Wings,DET,1,BOS,4,8,12,24,11,27,3,5,8,28,14,7
2022-23,3/12/2023,202303120NJD,New Jersey Devils,NJD,1,CAR,3,3,6,23,14,17,0,0,0,30,11,13
2022-23,3/12/2023,202303120PIT,Pittsburgh Penguins,PIT,1,NYR,3,5,8,35,42,21,2,3,5,28,42,15
2022-23,3/12/2023,202303120STL,Vegas Golden Knights,VEG,0,STL,5,9,14,29,10,15,3,6,9,33,25,10
2022-23,3/12/2023,202303120TBL,Winnipeg Jets,WPG,0,TBL,3,5,8,21,41,12,2,3,5,35,33,8
2022-23,3/11/2023,202303110BOS,Boston Bruins,BOS,1,DET,2,6,8,29,29,10,1,2,3,29,26,24
2022-23,3/11/2023,202303110BUF,Buffalo Sabres,BUF,1,NYR,1,2,3,33,18,13,2,4,6,26,23,21
2022-23,3/11/2023,202303110CAR,Carolina Hurricanes,CAR,1,VEG,0,0,0,33,13,9,4,5,9,22,24,19
2022-23,3/11/2023,202303110CBJ,Columbus Blue Jackets,CBJ,1,STL,2,4,6,36,15,14,5,9,14,24,15,14
2022-23,3/11/2023,202303110COL,Arizona Coyotes,ARI,0,COL,2,3,5,15,14,20,2,5,7,42,9,4
2022-23,3/11/2023,202303110FLA,Florida Panthers,FLA,1,WPG,4,7,11,48,37,13,5,10,15,27,27,16
2022-23,3/11/2023,202303110LAK,Los Angeles Kings,LAK,1,NSH,1,2,3,26,23,15,1,1,2,30,33,21
2022-23,3/11/2023,202303110MTL,Montreal Canadiens,MTL,1,NJD,1,1,2,23,34,23,3,5,8,37,17,20
2022-23,3/11/2023,202303110NYI,New York Islanders,NYI,1,WSH,1,0,1,17,19,10,5,8,13,23,23,18
2022-23,3/11/2023,202303110PIT,Philadelphia Flyers,PHI,0,PIT,0,0,0,28,23,15,5,10,15,32,31,12
2022-23,3/11/2023,202303110SEA,Dallas Stars,DAL,0,SEA,4,8,12,25,13,13,3,6,9,30,27,18
2022-23,3/11/2023,202303110SJS,Minnesota Wild,MIN,0,SJS,5,9,14,29,22,19,2,4,6,35,11,12
2022-23,3/11/2023,202303110TBL,Chicago Blackhawks,CHI,0,TBL,1,2,3,23,35,14,3,5,8,37,30,9
2022-23,3/11/2023,202303110TOR,Edmonton Oilers,EDM,0,TOR,4,8,12,26,23,12,7,8,15,38,22,10
2022-23,3/11/2023,202303110VAN,Ottawa Senators,OTT,0,VAN,1,4,5,19,28,11,4,8,12,25,21,9
2022-23,3/11/2023,202303110BOS,Detroit Red Wings,DET,0,BOS,1,2,3,29,26,24,2,6,8,29,29,10
2022-23,3/11/2023,202303110BUF,New York Rangers,NYR,0,BUF,2,4,6,26,23,21,1,2,3,33,18,13
2022-23,3/11/2023,202303110CAR,Vegas Golden Knights,VEG,0,CAR,4,5,9,22,24,19,0,0,0,33,13,9
2022-23,3/11/2023,202303110CBJ,St. Louis Blues,STL,0,CBJ,5,9,14,24,15,14,2,4,6,36,15,14
2022-23,3/11/2023,202303110COL,Colorado Avalanche,COL,1,ARI,2,5,7,42,9,4,2,3,5,15,14,20
2022-23,3/11/2023,202303110FLA,Winnipeg Jets,WPG,0,FLA,5,10,15,27,27,16,4,7,11,48,37,13
2022-23,3/11/2023,202303110LAK,Nashville Predators,NSH,0,LAK,1,1,2,30,33,21,1,2,3,26,23,15
2022-23,3/11/2023,202303110MTL,New Jersey Devils,NJD,0,MTL,3,5,8,37,17,20,1,1,2,23,34,23
2022-23,3/11/2023,202303110NYI,Washington Capitals,WSH,0,NYI,5,8,13,23,23,18,1,0,1,17,19,10
2022-23,3/11/2023,202303110PIT,Pittsburgh Penguins,PIT,1,PHI,5,10,15,32,31,12,0,0,0,28,23,15
2022-23,3/11/2023,202303110SEA,Seattle Kraken,SEA,1,DAL,3,6,9,30,27,18,4,8,12,25,13,13
2022-23,3/11/2023,202303110SJS,San Jose Sharks,SJS,1,MIN,2,4,6,35,11,12,5,9,14,29,22,19
2022-23,3/11/2023,202303110TBL,Tampa Bay Lightning,TBL,1,CHI,3,5,8,37,30,9,1,2,3,23,35,14
2022-23,3/11/2023,202303110TOR,Toronto Maple Leafs,TOR,1,EDM,7,8,15,38,22,10,4,8,12,26,23,12
2022-23,3/11/2023,202303110VAN,Vancouver Canucks,VAN,1,OTT,4,8,12,25,21,9,1,4,5,19,28,11
2022-23,3/10/2023,202303100CGY,Anaheim Ducks,ANA,0,CGY,2,5,7,15,11,12,1,2,3,36,10,9
2022-23,3/10/2023,202303100FLA,Chicago Blackhawks,CHI,0,FLA,3,6,9,23,18,19,4,8,12,41,23,8
2022-23,3/10/2023,202303100CGY,Calgary Flames,CGY,1,ANA,1,2,3,36,10,9,2,5,7,15,11,12
2022-23,3/10/2023,202303100FLA,Florida Panthers,FLA,1,CHI,4,8,12,41,23,8,3,6,9,23,18,19
2022-23,3/9/2023,202303090ARI,Arizona Coyotes,ARI,1,NSH,3,7,10,36,21,16,1,2,3,38,25,12
2022-23,3/9/2023,202303090BOS,Boston Bruins,BOS,1,EDM,2,2,4,23,30,9,3,4,7,22,31,13
2022-23,3/9/2023,202303090BUF,Buffalo Sabres,BUF,1,DAL,4,7,11,28,24,8,10,19,29,49,30,7
2022-23,3/9/2023,202303090CAR,Carolina Hurricanes,CAR,1,PHI,1,2,3,28,8,5,0,0,0,18,18,21
2022-23,3/9/2023,202303090COL,Colorado Avalanche,COL,1,LAK,2,4,6,27,17,6,5,9,14,31,24,14
2022-23,3/9/2023,202303090MTL,Montreal Canadiens,MTL,1,NYR,2,4,6,24,19,13,3,6,9,29,18,23
2022-23,3/9/2023,202303090PIT,New York Islanders,NYI,0,PIT,4,6,10,27,35,9,2,6,8,35,39,24
2022-23,3/9/2023,202303090SEA,Ottawa Senators,OTT,0,SEA,5,6,11,25,9,8,4,5,9,33,25,19
2022-23,3/9/2023,202303090STL,San Jose Sharks,SJS,0,STL,2,2,4,30,10,9,4,7,11,28,17,17
2022-23,3/9/2023,202303090TBL,Tampa Bay Lightning,TBL,1,VEG,3,6,9,37,36,10,4,7,11,21,32,18
2022-23,3/9/2023,202303090WSH,New Jersey Devils,NJD,0,WSH,2,4,6,40,12,15,2,2,4,20,13,13
2022-23,3/9/2023,202303090ARI,Nashville Predators,NSH,0,ARI,1,2,3,38,25,12,3,7,10,36,21,16
2022-23,3/9/2023,202303090BOS,Edmonton Oilers,EDM,0,BOS,3,4,7,22,31,13,2,2,4,23,30,9
2022-23,3/9/2023,202303090BUF,Dallas Stars,DAL,0,BUF,10,19,29,49,30,7,4,7,11,28,24,8
2022-23,3/9/2023,202303090CAR,Philadelphia Flyers,PHI,0,CAR,0,0,0,18,18,21,1,2,3,28,8,5
2022-23,3/9/2023,202303090COL,Los Angeles Kings,LAK,0,COL,5,9,14,31,24,14,2,4,6,27,17,6
2022-23,3/9/2023,202303090MTL,New York Rangers,NYR,0,MTL,3,6,9,29,18,23,2,4,6,24,19,13
2022-23,3/9/2023,202303090PIT,Pittsburgh Penguins,PIT,1,NYI,2,6,8,35,39,24,4,6,10,27,35,9
2022-23,3/9/2023,202303090SEA,Seattle Kraken,SEA,1,OTT,4,5,9,33,25,19,5,6,11,25,9,8
2022-23,3/9/2023,202303090STL,St. Louis Blues,STL,1,SJS,4,7,11,28,17,17,2,2,4,30,10,9
2022-23,3/9/2023,202303090TBL,Vegas Golden Knights,VEG,0,TBL,4,7,11,21,32,18,3,6,9,37,36,10
2022-23,3/9/2023,202303090WSH,Washington Capitals,WSH,1,NJD,2,2,4,20,13,13,2,4,6,40,12,15
2022-23,3/8/2023,202303080DET,Chicago Blackhawks,CHI,0,DET,3,5,8,19,17,11,4,6,10,41,10,12
2022-23,3/8/2023,202303080VAN,Anaheim Ducks,ANA,0,VAN,2,4,6,17,7,9,3,4,7,29,19,11
2022-23,3/8/2023,202303080WPG,Minnesota Wild,MIN,0,WPG,4,7,11,23,16,25,2,4,6,48,14,5
2022-23,3/8/2023,202303080DET,Detroit Red Wings,DET,1,CHI,4,6,10,41,10,12,3,5,8,19,17,11
2022-23,3/8/2023,202303080VAN,Vancouver Canucks,VAN,1,ANA,3,4,7,29,19,11,2,4,6,17,7,9
2022-23,3/8/2023,202303080WPG,Winnipeg Jets,WPG,1,MIN,2,4,6,48,14,5,4,7,11,23,16,25
2022-23,3/7/2023,202303070ARI,Arizona Coyotes,ARI,1,STL,6,11,17,23,18,15,2,4,6,42,23,11
2022-23,3/7/2023,202303070COL,Colorado Avalanche,COL,1,SJS,5,12,17,40,24,16,0,0,0,11,39,14
2022-23,3/7/2023,202303070FLA,Florida Panthers,FLA,1,VEG,2,3,5,29,25,11,1,2,3,22,11,29
2022-23,3/7/2023,202303070MIN,Calgary Flames,CGY,0,MIN,0,0,0,24,23,10,0,0,0,40,18,23
2022-23,3/7/2023,202303070MTL,Carolina Hurricanes,CAR,0,MTL,3,3,6,37,10,8,2,4,6,21,17,21
2022-23,3/7/2023,202303070NJD,New Jersey Devils,NJD,1,TOR,3,5,8,33,20,8,4,6,10,25,14,15
2022-23,3/7/2023,202303070NYI,Buffalo Sabres,BUF,0,NYI,2,1,3,24,9,8,2,4,6,38,22,31
2022-23,3/7/2023,202303070PIT,Columbus Blue Jackets,CBJ,0,PIT,3,6,9,26,29,25,5,8,13,45,45,9
2022-23,3/7/2023,202303070SEA,Anaheim Ducks,ANA,0,SEA,2,3,5,21,6,7,5,8,13,29,11,12
2022-23,3/7/2023,202303070TBL,Philadelphia Flyers,PHI,0,TBL,2,4,6,32,23,21,5,9,14,39,26,17
2022-23,3/7/2023,202303070ARI,St. Louis Blues,STL,0,ARI,2,4,6,42,23,11,6,11,17,23,18,15
2022-23,3/7/2023,202303070COL,San Jose Sharks,SJS,0,COL,0,0,0,11,39,14,5,12,17,40,24,16
2022-23,3/7/2023,202303070FLA,Vegas Golden Knights,VEG,0,FLA,1,2,3,22,11,29,2,3,5,29,25,11
2022-23,3/7/2023,202303070MIN,Minnesota Wild,MIN,1,CGY,0,0,0,40,18,23,0,0,0,24,23,10
2022-23,3/7/2023,202303070MTL,Montreal Canadiens,MTL,1,CAR,2,4,6,21,17,21,3,3,6,37,10,8
2022-23,3/7/2023,202303070NJD,Toronto Maple Leafs,TOR,0,NJD,4,6,10,25,14,15,3,5,8,33,20,8
2022-23,3/7/2023,202303070NYI,New York Islanders,NYI,1,BUF,2,4,6,38,22,31,2,1,3,24,9,8
2022-23,3/7/2023,202303070PIT,Pittsburgh Penguins,PIT,1,CBJ,5,8,13,45,45,9,3,6,9,26,29,25
2022-23,3/7/2023,202303070SEA,Seattle Kraken,SEA,1,ANA,5,8,13,29,11,12,2,3,5,21,6,7
2022-23,3/7/2023,202303070TBL,Tampa Bay Lightning,TBL,1,PHI,5,9,14,39,26,17,2,4,6,32,23,21
2022-23,3/6/2023,202303060BUF,Buffalo Sabres,BUF,1,EDM,2,3,5,39,18,11,3,6,9,37,24,7
2022-23,3/6/2023,202303060CHI,Chicago Blackhawks,CHI,1,OTT,5,5,10,18,20,17,0,0,0,32,24,3
2022-23,3/6/2023,202303060DAL,Calgary Flames,CGY,0,DAL,4,7,11,34,30,13,4,7,11,33,24,9
2022-23,3/6/2023,202303060LAK,Los Angeles Kings,LAK,1,WSH,4,7,11,41,23,7,2,4,6,21,18,9
2022-23,3/6/2023,202303060VAN,Nashville Predators,NSH,0,VAN,3,5,8,30,18,9,3,5,8,23,36,13
2022-23,3/6/2023,202303060WPG,San Jose Sharks,SJS,0,WPG,3,5,8,21,19,16,2,4,6,37,17,18
2022-23,3/6/2023,202303060BUF,Edmonton Oilers,EDM,0,BUF,3,6,9,37,24,7,2,3,5,39,18,11
2022-23,3/6/2023,202303060CHI,Ottawa Senators,OTT,0,CHI,0,0,0,32,24,3,5,5,10,18,20,17
2022-23,3/6/2023,202303060DAL,Dallas Stars,DAL,1,CGY,4,7,11,33,24,9,4,7,11,34,30,13
2022-23,3/6/2023,202303060LAK,Washington Capitals,WSH,0,LAK,2,4,6,21,18,9,4,7,11,41,23,7
2022-23,3/6/2023,202303060VAN,Vancouver Canucks,VAN,1,NSH,3,5,8,23,36,13,3,5,8,30,18,9
2022-23,3/6/2023,202303060WPG,Winnipeg Jets,WPG,1,SJS,2,4,6,37,17,18,3,5,8,21,19,16
2022-23,3/5/2023,202303050ARI,Arizona Coyotes,ARI,1,NJD,3,8,11,22,28,19,5,8,13,40,22,15
2022-23,3/5/2023,202303050CAR,Carolina Hurricanes,CAR,1,TBL,6,10,16,38,11,9,0,0,0,14,18,12
2022-23,3/5/2023,202303050COL,Colorado Avalanche,COL,1,SEA,1,4,5,21,16,16,3,5,8,35,21,9
2022-23,3/5/2023,202303050PHI,Detroit Red Wings,DET,0,PHI,1,1,2,26,22,19,3,2,5,32,17,16
2022-23,3/5/2023,202303050VEG,Montreal Canadiens,MTL,0,VEG,2,5,7,24,27,29,4,6,10,27,31,18
2022-23,3/5/2023,202303050ARI,New Jersey Devils,NJD,0,ARI,5,8,13,40,22,15,3,8,11,22,28,19
2022-23,3/5/2023,202303050CAR,Tampa Bay Lightning,TBL,0,CAR,0,0,0,14,18,12,6,10,16,38,11,9
2022-23,3/5/2023,202303050COL,Seattle Kraken,SEA,0,COL,3,5,8,35,21,9,1,4,5,21,16,16
2022-23,3/5/2023,202303050PHI,Philadelphia Flyers,PHI,1,DET,3,2,5,32,17,16,1,1,2,26,22,19
2022-23,3/5/2023,202303050VEG,Vegas Golden Knights,VEG,1,MTL,4,6,10,27,31,18,2,5,7,24,27,29
2022-23,3/4/2023,202303040BOS,Boston Bruins,BOS,1,NYR,3,6,9,19,24,9,2,4,6,25,22,13
2022-23,3/4/2023,202303040BUF,Buffalo Sabres,BUF,1,TBL,5,5,10,34,15,13,3,6,9,36,28,12
2022-23,3/4/2023,202303040CGY,Calgary Flames,CGY,1,MIN,0,0,0,31,23,15,3,5,8,33,18,20
2022-23,3/4/2023,202303040CHI,Chicago Blackhawks,CHI,1,NSH,1,2,3,28,27,10,3,6,9,23,20,10
2022-23,3/4/2023,202303040DAL,Colorado Avalanche,COL,0,DAL,3,5,8,31,18,15,7,8,15,29,23,20
2022-23,3/4/2023,202303040FLA,Florida Panthers,FLA,1,PIT,4,7,11,41,21,12,1,2,3,31,13,13
2022-23,3/4/2023,202303040LAK,Los Angeles Kings,LAK,1,STL,4,7,11,38,14,12,2,3,5,23,24,15
2022-23,3/4/2023,202303040NYI,Detroit Red Wings,DET,0,NYI,1,2,3,22,17,11,4,6,10,33,21,12
2022-23,3/4/2023,202303040OTT,Columbus Blue Jackets,CBJ,0,OTT,2,1,3,20,20,11,5,9,14,37,23,13
2022-23,3/4/2023,202303040SJS,San Jose Sharks,SJS,1,WSH,3,5,8,38,20,20,7,13,20,27,23,16
2022-23,3/4/2023,202303040VAN,Toronto Maple Leafs,TOR,0,VAN,1,2,3,37,16,16,4,8,12,22,21,14
2022-23,3/4/2023,202303040WPG,Edmonton Oilers,EDM,0,WPG,5,7,12,35,13,15,6,10,16,35,26,17
2022-23,3/4/2023,202303040BOS,New York Rangers,NYR,0,BOS,2,4,6,25,22,13,3,6,9,19,24,9
2022-23,3/4/2023,202303040BUF,Tampa Bay Lightning,TBL,0,BUF,3,6,9,36,28,12,5,5,10,34,15,13
2022-23,3/4/2023,202303040CGY,Minnesota Wild,MIN,0,CGY,3,5,8,33,18,20,0,0,0,31,23,15
2022-23,3/4/2023,202303040CHI,Nashville Predators,NSH,0,CHI,3,6,9,23,20,10,1,2,3,28,27,10
2022-23,3/4/2023,202303040DAL,Dallas Stars,DAL,1,COL,7,8,15,29,23,20,3,5,8,31,18,15
2022-23,3/4/2023,202303040FLA,Pittsburgh Penguins,PIT,0,FLA,1,2,3,31,13,13,4,7,11,41,21,12
2022-23,3/4/2023,202303040LAK,St. Louis Blues,STL,0,LAK,2,3,5,23,24,15,4,7,11,38,14,12
2022-23,3/4/2023,202303040NYI,New York Islanders,NYI,1,DET,4,6,10,33,21,12,1,2,3,22,17,11
2022-23,3/4/2023,202303040OTT,Ottawa Senators,OTT,1,CBJ,5,9,14,37,23,13,2,1,3,20,20,11
2022-23,3/4/2023,202303040SJS,Washington Capitals,WSH,0,SJS,7,13,20,27,23,16,3,5,8,38,20,20
2022-23,3/4/2023,202303040VAN,Vancouver Canucks,VAN,1,TOR,4,8,12,22,21,14,1,2,3,37,16,16
2022-23,3/4/2023,202303040WPG,Winnipeg Jets,WPG,1,EDM,6,10,16,35,26,17,5,7,12,35,13,15
2022-23,3/3/2023,202303030ANA,Anaheim Ducks,ANA,1,MTL,3,4,7,23,10,8,2,4,6,27,11,17
2022-23,3/3/2023,202303030ARI,Arizona Coyotes,ARI,1,CAR,1,2,3,17,24,15,5,12,17,38,20,8
2022-23,3/3/2023,202303030CBJ,Columbus Blue Jackets,CBJ,1,SEA,2,4,6,22,19,18,4,7,11,34,10,10
2022-23,3/3/2023,202303030EDM,Edmonton Oilers,EDM,1,WPG,6,9,15,33,11,9,3,3,6,27,23,11
2022-23,3/3/2023,202303030VEG,New Jersey Devils,NJD,0,VEG,3,3,6,50,17,15,3,5,8,25,37,27
2022-23,3/3/2023,202303030ANA,Montreal Canadiens,MTL,0,ANA,2,4,6,27,11,17,3,4,7,23,10,8
2022-23,3/3/2023,202303030ARI,Carolina Hurricanes,CAR,0,ARI,5,12,17,38,20,8,1,2,3,17,24,15
2022-23,3/3/2023,202303030CBJ,Seattle Kraken,SEA,0,CBJ,4,7,11,34,10,10,2,4,6,22,19,18
2022-23,3/3/2023,202303030EDM,Winnipeg Jets,WPG,0,EDM,3,3,6,27,23,11,6,9,15,33,11,9
2022-23,3/3/2023,202303030VEG,Vegas Golden Knights,VEG,1,NJD,3,5,8,25,37,27,3,3,6,50,17,15
2022-23,3/2/2023,202303020BOS,Boston Bruins,BOS,1,BUF,6,12,18,35,26,12,1,2,3,27,16,6
2022-23,3/2/2023,202303020CGY,Calgary Flames,CGY,1,TOR,1,0,1,26,20,8,2,4,6,34,18,18
2022-23,3/2/2023,202303020CHI,Chicago Blackhawks,CHI,1,DAL,2,2,4,21,25,18,5,8,13,35,17,15
2022-23,3/2/2023,202303020DET,Detroit Red Wings,DET,1,SEA,4,6,10,29,38,18,5,10,15,37,20,7
2022-23,3/2/2023,202303020FLA,Florida Panthers,FLA,1,NSH,1,2,3,30,14,10,2,4,6,23,33,28
2022-23,3/2/2023,202303020LAK,Los Angeles Kings,LAK,1,MTL,3,4,7,33,20,15,2,2,4,20,19,12
2022-23,3/2/2023,202303020NYR,New York Rangers,NYR,1,OTT,3,5,8,31,20,8,3,8,11,32,13,14
2022-23,3/2/2023,202303020SJS,San Jose Sharks,SJS,1,STL,3,4,7,22,14,8,5,10,15,20,28,15
2022-23,3/2/2023,202303020TBL,Pittsburgh Penguins,PIT,0,TBL,5,8,13,32,24,9,4,7,11,31,31,12
2022-23,3/2/2023,202303020VAN,Minnesota Wild,MIN,0,VAN,2,4,6,36,20,18,1,1,2,15,27,9
2022-23,3/2/2023,202303020BOS,Buffalo Sabres,BUF,0,BOS,1,2,3,27,16,6,6,12,18,35,26,12
2022-23,3/2/2023,202303020CGY,Toronto Maple Leafs,TOR,0,CGY,2,4,6,34,18,18,1,0,1,26,20,8
2022-23,3/2/2023,202303020CHI,Dallas Stars,DAL,0,CHI,5,8,13,35,17,15,2,2,4,21,25,18
2022-23,3/2/2023,202303020DET,Seattle Kraken,SEA,0,DET,5,10,15,37,20,7,4,6,10,29,38,18
2022-23,3/2/2023,202303020FLA,Nashville Predators,NSH,0,FLA,2,4,6,23,33,28,1,2,3,30,14,10
2022-23,3/2/2023,202303020LAK,Montreal Canadiens,MTL,0,LAK,2,2,4,20,19,12,3,4,7,33,20,15
2022-23,3/2/2023,202303020NYR,Ottawa Senators,OTT,0,NYR,3,8,11,32,13,14,3,5,8,31,20,8
2022-23,3/2/2023,202303020SJS,St. Louis Blues,STL,0,SJS,5,10,15,20,28,15,3,4,7,22,14,8
2022-23,3/2/2023,202303020TBL,Tampa Bay Lightning,TBL,1,PIT,4,7,11,31,31,12,5,8,13,32,24,9
2022-23,3/2/2023,202303020VAN,Vancouver Canucks,VAN,1,MIN,1,1,2,15,27,9,2,4,6,36,20,18
2022-23,3/1/2023,202303010ANA,Anaheim Ducks,ANA,1,WSH,2,4,6,20,15,7,3,5,8,37,14,6
2022-23,3/1/2023,202303010COL,Colorado Avalanche,COL,1,NJD,5,7,12,30,23,15,7,13,20,29,13,17
2022-23,3/1/2023,202303010DAL,Arizona Coyotes,ARI,0,DAL,2,4,6,16,14,10,4,6,10,38,20,12
2022-23,3/1/2023,202303010EDM,Edmonton Oilers,EDM,1,TOR,5,10,15,32,25,14,2,3,5,28,22,13
2022-23,3/1/2023,202303010PHI,New York Rangers,NYR,0,PHI,3,6,9,25,29,6,2,1,3,25,30,11
2022-23,3/1/2023,202303010VEG,Carolina Hurricanes,CAR,0,VEG,2,3,5,23,24,16,3,5,8,19,29,20
2022-23,3/1/2023,202303010ANA,Washington Capitals,WSH,0,ANA,3,5,8,37,14,6,2,4,6,20,15,7
2022-23,3/1/2023,202303010COL,New Jersey Devils,NJD,0,COL,7,13,20,29,13,17,5,7,12,30,23,15
2022-23,3/1/2023,202303010DAL,Dallas Stars,DAL,1,ARI,4,6,10,38,20,12,2,4,6,16,14,10
2022-23,3/1/2023,202303010EDM,Toronto Maple Leafs,TOR,0,EDM,2,3,5,28,22,13,5,10,15,32,25,14
2022-23,3/1/2023,202303010PHI,Philadelphia Flyers,PHI,1,NYR,2,1,3,25,30,11,3,6,9,25,29,6
2022-23,3/1/2023,202303010VEG,Vegas Golden Knights,VEG,1,CAR,3,5,8,19,29,20,2,3,5,23,24,16
2022-23,2/28/2023,202302280ARI,Arizona Coyotes,ARI,1,CHI,4,6,10,29,24,12,1,2,3,23,20,13
2022-23,2/28/2023,202302280BUF,Buffalo Sabres,BUF,1,CBJ,3,5,8,41,10,10,5,6,11,32,22,12
2022-23,2/28/2023,202302280CGY,Boston Bruins,BOS,0,CGY,4,6,10,16,11,22,3,5,8,57,24,14
2022-23,2/28/2023,202302280MIN,Minnesota Wild,MIN,1,NYI,1,1,2,31,26,13,0,1,1,38,26,16
2022-23,2/28/2023,202302280NSH,Nashville Predators,NSH,1,PIT,1,0,1,25,34,24,3,4,7,34,24,20
2022-23,2/28/2023,202302280OTT,Detroit Red Wings,DET,0,OTT,1,1,2,17,34,13,6,7,13,25,20,11
2022-23,2/28/2023,202302280SJS,Montreal Canadiens,MTL,0,SJS,3,4,7,31,18,18,1,0,1,33,12,11
2022-23,2/28/2023,202302280STL,Seattle Kraken,SEA,0,STL,5,10,15,26,16,16,3,4,7,25,21,18
2022-23,2/28/2023,202302280TBL,Florida Panthers,FLA,0,TBL,3,5,8,36,25,21,1,2,3,29,29,15
2022-23,2/28/2023,202302280WPG,Los Angeles Kings,LAK,0,WPG,5,8,13,37,24,23,5,8,13,30,30,18
2022-23,2/28/2023,202302280ARI,Chicago Blackhawks,CHI,0,ARI,1,2,3,23,20,13,4,6,10,29,24,12
2022-23,2/28/2023,202302280BUF,Columbus Blue Jackets,CBJ,0,BUF,5,6,11,32,22,12,3,5,8,41,10,10
2022-23,2/28/2023,202302280CGY,Calgary Flames,CGY,1,BOS,3,5,8,57,24,14,4,6,10,16,11,22
2022-23,2/28/2023,202302280MIN,New York Islanders,NYI,0,MIN,0,1,1,38,26,16,1,1,2,31,26,13
2022-23,2/28/2023,202302280NSH,Pittsburgh Penguins,PIT,0,NSH,3,4,7,34,24,20,1,0,1,25,34,24
2022-23,2/28/2023,202302280OTT,Ottawa Senators,OTT,1,DET,6,7,13,25,20,11,1,1,2,17,34,13
2022-23,2/28/2023,202302280SJS,San Jose Sharks,SJS,1,MTL,1,0,1,33,12,11,3,4,7,31,18,18
2022-23,2/28/2023,202302280STL,St. Louis Blues,STL,1,SEA,3,4,7,25,21,18,5,10,15,26,16,16
2022-23,2/28/2023,202302280TBL,Tampa Bay Lightning,TBL,1,FLA,1,2,3,29,29,15,3,5,8,36,25,21
2022-23,2/28/2023,202302280WPG,Winnipeg Jets,WPG,1,LAK,5,8,13,30,30,18,5,8,13,37,24,23
2022-23,2/27/2023,202302270ANA,Anaheim Ducks,ANA,1,CHI,4,8,12,28,9,5,2,4,6,22,12,14
2022-23,2/27/2023,202302270COL,Colorado Avalanche,COL,1,VEG,3,3,6,32,16,11,0,0,0,27,21,19
2022-23,2/27/2023,202302270DAL,Dallas Stars,DAL,1,VAN,4,7,11,38,15,9,4,8,12,19,19,21
2022-23,2/27/2023,202302270EDM,Boston Bruins,BOS,0,EDM,3,6,9,28,22,14,2,3,5,24,22,20
2022-23,2/27/2023,202302270OTT,Detroit Red Wings,DET,0,OTT,2,3,5,24,31,16,6,8,14,40,34,13
2022-23,2/27/2023,202302270ANA,Chicago Blackhawks,CHI,0,ANA,2,4,6,22,12,14,4,8,12,28,9,5
2022-23,2/27/2023,202302270COL,Vegas Golden Knights,VEG,0,COL,0,0,0,27,21,19,3,3,6,32,16,11
2022-23,2/27/2023,202302270DAL,Vancouver Canucks,VAN,0,DAL,4,8,12,19,19,21,4,7,11,38,15,9
2022-23,2/27/2023,202302270EDM,Edmonton Oilers,EDM,1,BOS,2,3,5,24,22,20,3,6,9,28,22,14
2022-23,2/27/2023,202302270OTT,Ottawa Senators,OTT,1,DET,6,8,14,40,34,13,2,3,5,24,31,16
2022-23,2/26/2023,202302260ARI,Arizona Coyotes,ARI,1,NSH,2,3,5,24,21,12,6,12,18,33,21,15
2022-23,2/26/2023,202302260BUF,Buffalo Sabres,BUF,1,WSH,7,11,18,37,5,9,4,6,10,29,17,9
2022-23,2/26/2023,202302260MIN,Columbus Blue Jackets,CBJ,0,MIN,2,3,5,21,11,13,3,6,9,44,31,17
2022-23,2/26/2023,202302260NYR,Los Angeles Kings,LAK,0,NYR,2,3,5,28,9,11,5,8,13,19,17,12
2022-23,2/26/2023,202302260PIT,Pittsburgh Penguins,PIT,1,TBL,7,11,18,36,31,16,3,5,8,29,28,15
2022-23,2/26/2023,202302260SEA,Seattle Kraken,SEA,1,TOR,1,2,3,27,22,10,5,9,14,33,10,18
2022-23,2/26/2023,202302260WPG,New York Islanders,NYI,0,WPG,4,4,8,22,19,22,0,0,0,23,16,9
2022-23,2/26/2023,202302260ARI,Nashville Predators,NSH,0,ARI,6,12,18,33,21,15,2,3,5,24,21,12
2022-23,2/26/2023,202302260BUF,Washington Capitals,WSH,0,BUF,4,6,10,29,17,9,7,11,18,37,5,9
2022-23,2/26/2023,202302260MIN,Minnesota Wild,MIN,1,CBJ,3,6,9,44,31,17,2,3,5,21,11,13
2022-23,2/26/2023,202302260NYR,New York Rangers,NYR,1,LAK,5,8,13,19,17,12,2,3,5,28,9,11
2022-23,2/26/2023,202302260PIT,Tampa Bay Lightning,TBL,0,PIT,3,5,8,29,28,15,7,11,18,36,31,16
2022-23,2/26/2023,202302260SEA,Toronto Maple Leafs,TOR,0,SEA,5,9,14,33,10,18,1,2,3,27,22,10
2022-23,2/26/2023,202302260WPG,Winnipeg Jets,WPG,1,NYI,0,0,0,23,16,9,4,4,8,22,19,22
2022-23,2/25/2023,202302250CAR,Anaheim Ducks,ANA,0,CAR,3,6,9,16,4,16,2,3,5,50,11,6
2022-23,2/25/2023,202302250CBJ,Columbus Blue Jackets,CBJ,1,EDM,6,9,15,26,13,13,5,7,12,47,17,8
2022-23,2/25/2023,202302250COL,Calgary Flames,CGY,0,COL,1,2,3,29,24,10,3,6,9,20,17,24
2022-23,2/25/2023,202302250DET,Detroit Red Wings,DET,1,TBL,0,0,0,45,9,10,3,5,8,18,9,29
2022-23,2/25/2023,202302250MTL,Montreal Canadiens,MTL,1,OTT,2,2,4,28,11,14,4,5,9,21,17,12
2022-23,2/25/2023,202302250NJD,New Jersey Devils,NJD,1,PHI,7,11,18,36,10,14,0,0,0,18,10,7
2022-23,2/25/2023,202302250SJS,Chicago Blackhawks,CHI,0,SJS,2,4,6,33,16,19,2,6,8,40,22,8
2022-23,2/25/2023,202302250STL,Pittsburgh Penguins,PIT,0,STL,3,6,9,47,25,14,2,4,6,26,38,13
2022-23,2/25/2023,202302250VAN,Boston Bruins,BOS,0,VAN,2,2,4,31,14,7,1,1,2,21,19,8
2022-23,2/25/2023,202302250VEG,Dallas Stars,DAL,0,VEG,2,4,6,43,33,18,2,4,6,41,38,17
2022-23,2/25/2023,202302250WSH,New York Rangers,NYR,0,WSH,3,5,8,26,25,12,6,12,18,25,15,15
2022-23,2/25/2023,202302250CAR,Carolina Hurricanes,CAR,1,ANA,2,3,5,50,11,6,3,6,9,16,4,16
2022-23,2/25/2023,202302250CBJ,Edmonton Oilers,EDM,0,CBJ,5,7,12,47,17,8,6,9,15,26,13,13
2022-23,2/25/2023,202302250COL,Colorado Avalanche,COL,1,CGY,3,6,9,20,17,24,1,2,3,29,24,10
2022-23,2/25/2023,202302250DET,Tampa Bay Lightning,TBL,0,DET,3,5,8,18,9,29,0,0,0,45,9,10
2022-23,2/25/2023,202302250MTL,Ottawa Senators,OTT,0,MTL,4,5,9,21,17,12,2,2,4,28,11,14
2022-23,2/25/2023,202302250NJD,Philadelphia Flyers,PHI,0,NJD,0,0,0,18,10,7,7,11,18,36,10,14
2022-23,2/25/2023,202302250SJS,San Jose Sharks,SJS,1,CHI,2,6,8,40,22,8,2,4,6,33,16,19
2022-23,2/25/2023,202302250STL,St. Louis Blues,STL,1,PIT,2,4,6,26,38,13,3,6,9,47,25,14
2022-23,2/25/2023,202302250VAN,Vancouver Canucks,VAN,1,BOS,1,1,2,21,19,8,2,2,4,31,14,7
2022-23,2/25/2023,202302250VEG,Vegas Golden Knights,VEG,1,DAL,2,4,6,41,38,17,2,4,6,43,33,18
2022-23,2/25/2023,202302250WSH,Washington Capitals,WSH,1,NYR,6,12,18,25,15,15,3,5,8,26,25,12
2022-23,2/24/2023,202302240CAR,Carolina Hurricanes,CAR,1,OTT,4,4,8,26,16,11,0,0,0,29,27,10
2022-23,2/24/2023,202302240FLA,Buffalo Sabres,BUF,0,FLA,3,5,8,33,24,13,1,2,3,50,21,8
2022-23,2/24/2023,202302240NYI,Los Angeles Kings,LAK,0,NYI,3,3,6,27,11,11,2,4,6,17,17,10
2022-23,2/24/2023,202302240PHI,Montreal Canadiens,MTL,0,PHI,5,9,14,26,13,12,2,3,5,25,27,18
2022-23,2/24/2023,202302240TOR,Minnesota Wild,MIN,0,TOR,1,1,2,25,42,18,2,2,4,24,27,26
2022-23,2/24/2023,202302240WPG,Colorado Avalanche,COL,0,WPG,5,9,14,34,18,11,1,2,3,24,19,10
2022-23,2/24/2023,202302240CAR,Ottawa Senators,OTT,0,CAR,0,0,0,29,27,10,4,4,8,26,16,11
2022-23,2/24/2023,202302240FLA,Florida Panthers,FLA,1,BUF,1,2,3,50,21,8,3,5,8,33,24,13
2022-23,2/24/2023,202302240NYI,New York Islanders,NYI,1,LAK,2,4,6,17,17,10,3,3,6,27,11,11
2022-23,2/24/2023,202302240PHI,Philadelphia Flyers,PHI,1,MTL,2,3,5,25,27,18,5,9,14,26,13,12
2022-23,2/24/2023,202302240TOR,Toronto Maple Leafs,TOR,1,MIN,2,2,4,24,27,26,1,1,2,25,42,18
2022-23,2/24/2023,202302240WPG,Winnipeg Jets,WPG,1,COL,1,2,3,24,19,10,5,9,14,34,18,11
2022-23,2/23/2023,202302230CBJ,Columbus Blue Jackets,CBJ,1,MIN,0,0,0,28,9,11,2,3,5,25,19,25
2022-23,2/23/2023,202302230DET,Detroit Red Wings,DET,1,NYR,4,7,11,23,22,22,1,0,1,31,12,9
2022-23,2/23/2023,202302230NJD,Los Angeles Kings,LAK,0,NJD,3,6,9,22,16,19,4,6,10,32,21,8
2022-23,2/23/2023,202302230PIT,Edmonton Oilers,EDM,0,PIT,7,10,17,44,18,11,2,4,6,24,31,10
2022-23,2/23/2023,202302230SEA,Boston Bruins,BOS,0,SEA,4,8,12,25,16,10,5,8,13,41,17,10
2022-23,2/23/2023,202302230SJS,Nashville Predators,NSH,0,SJS,6,10,16,30,18,19,1,3,4,18,12,12
2022-23,2/23/2023,202302230STL,St. Louis Blues,STL,1,VAN,2,3,5,22,27,17,3,5,8,35,8,9
2022-23,2/23/2023,202302230TBL,Buffalo Sabres,BUF,0,TBL,6,7,13,23,42,9,5,10,15,41,42,13
2022-23,2/23/2023,202302230VEG,Calgary Flames,CGY,0,VEG,3,6,9,28,50,19,4,7,11,26,40,21
2022-23,2/23/2023,202302230WSH,Anaheim Ducks,ANA,0,WSH,3,5,8,18,6,12,2,4,6,42,21,20
2022-23,2/23/2023,202302230CBJ,Minnesota Wild,MIN,0,CBJ,2,3,5,25,19,25,0,0,0,28,9,11
2022-23,2/23/2023,202302230DET,New York Rangers,NYR,0,DET,1,0,1,31,12,9,4,7,11,23,22,22
2022-23,2/23/2023,202302230NJD,New Jersey Devils,NJD,1,LAK,4,6,10,32,21,8,3,6,9,22,16,19
2022-23,2/23/2023,202302230PIT,Pittsburgh Penguins,PIT,1,EDM,2,4,6,24,31,10,7,10,17,44,18,11
2022-23,2/23/2023,202302230SEA,Seattle Kraken,SEA,1,BOS,5,8,13,41,17,10,4,8,12,25,16,10
2022-23,2/23/2023,202302230SJS,San Jose Sharks,SJS,1,NSH,1,3,4,18,12,12,6,10,16,30,18,19
2022-23,2/23/2023,202302230STL,Vancouver Canucks,VAN,0,STL,3,5,8,35,8,9,2,3,5,22,27,17
2022-23,2/23/2023,202302230TBL,Tampa Bay Lightning,TBL,1,BUF,5,10,15,41,42,13,6,7,13,23,42,9
2022-23,2/23/2023,202302230VEG,Vegas Golden Knights,VEG,1,CGY,4,7,11,26,40,21,3,6,9,28,50,19
2022-23,2/23/2023,202302230WSH,Washington Capitals,WSH,1,ANA,2,4,6,42,21,20,3,5,8,18,6,12
2022-23,2/22/2023,202302220ARI,Arizona Coyotes,ARI,1,CGY,3,2,5,13,22,19,6,12,18,51,25,11
2022-23,2/22/2023,202302220DAL,Chicago Blackhawks,CHI,0,DAL,4,5,9,23,17,22,3,3,6,32,13,11
2022-23,2/22/2023,202302220NYI,New York Islanders,NYI,1,WPG,2,3,5,18,23,17,1,2,3,23,10,10
2022-23,2/22/2023,202302220ARI,Calgary Flames,CGY,0,ARI,6,12,18,51,25,11,3,2,5,13,22,19
2022-23,2/22/2023,202302220DAL,Dallas Stars,DAL,1,CHI,3,3,6,32,13,11,4,5,9,23,17,22
2022-23,2/22/2023,202302220NYI,Winnipeg Jets,WPG,0,NYI,1,2,3,23,10,10,2,3,5,18,23,17
2022-23,2/21/2023,202302210BUF,Buffalo Sabres,BUF,1,TOR,3,5,8,32,17,7,6,11,17,29,16,18
2022-23,2/21/2023,202302210CAR,Carolina Hurricanes,CAR,1,STL,4,6,10,32,10,5,1,0,1,31,26,18
2022-23,2/21/2023,202302210CHI,Chicago Blackhawks,CHI,1,VEG,2,4,6,39,23,17,2,2,4,36,18,15
2022-23,2/21/2023,202302210EDM,Edmonton Oilers,EDM,1,PHI,4,5,9,27,28,13,2,3,5,23,17,16
2022-23,2/21/2023,202302210MIN,Los Angeles Kings,LAK,0,MIN,1,2,3,34,13,11,2,2,4,20,18,22
2022-23,2/21/2023,202302210NJD,Montreal Canadiens,MTL,0,NJD,5,8,13,18,15,21,2,3,5,40,16,9
2022-23,2/21/2023,202302210NSH,Nashville Predators,NSH,1,VAN,4,7,11,26,25,24,3,8,11,36,20,11
2022-23,2/21/2023,202302210TBL,Anaheim Ducks,ANA,0,TBL,1,2,3,23,21,10,6,11,17,44,25,7
2022-23,2/21/2023,202302210WSH,Detroit Red Wings,DET,0,WSH,3,2,5,25,23,28,1,2,3,27,26,13
2022-23,2/21/2023,202302210BUF,Toronto Maple Leafs,TOR,0,BUF,6,11,17,29,16,18,3,5,8,32,17,7
2022-23,2/21/2023,202302210CAR,St. Louis Blues,STL,0,CAR,1,0,1,31,26,18,4,6,10,32,10,5
2022-23,2/21/2023,202302210CHI,Vegas Golden Knights,VEG,0,CHI,2,2,4,36,18,15,2,4,6,39,23,17
2022-23,2/21/2023,202302210EDM,Philadelphia Flyers,PHI,0,EDM,2,3,5,23,17,16,4,5,9,27,28,13
2022-23,2/21/2023,202302210MIN,Minnesota Wild,MIN,1,LAK,2,2,4,20,18,22,1,2,3,34,13,11
2022-23,2/21/2023,202302210NJD,New Jersey Devils,NJD,1,MTL,2,3,5,40,16,9,5,8,13,18,15,21
2022-23,2/21/2023,202302210NSH,Vancouver Canucks,VAN,0,NSH,3,8,11,36,20,11,4,7,11,26,25,24
2022-23,2/21/2023,202302210TBL,Tampa Bay Lightning,TBL,1,ANA,6,11,17,44,25,7,1,2,3,23,21,10
2022-23,2/21/2023,202302210WSH,Washington Capitals,WSH,1,DET,1,2,3,27,26,13,3,2,5,25,23,28
2022-23,2/20/2023,202302200BOS,Boston Bruins,BOS,1,OTT,3,4,7,25,30,13,1,0,1,29,32,17
2022-23,2/20/2023,202302200CGY,Calgary Flames,CGY,1,PHI,3,6,9,35,15,7,3,7,10,21,10,27
2022-23,2/20/2023,202302200FLA,Anaheim Ducks,ANA,0,FLA,3,5,8,30,10,21,3,7,10,51,23,10
2022-23,2/20/2023,202302200NYR,New York Rangers,NYR,1,WPG,1,1,2,51,20,9,4,8,12,21,18,10
2022-23,2/20/2023,202302200PIT,New York Islanders,NYI,0,PIT,4,5,9,28,26,13,2,4,6,46,25,23
2022-23,2/20/2023,202302200SJS,Seattle Kraken,SEA,0,SJS,0,0,0,26,24,7,3,3,6,18,17,12
2022-23,2/20/2023,202302200BOS,Ottawa Senators,OTT,0,BOS,1,0,1,29,32,17,3,4,7,25,30,13
2022-23,2/20/2023,202302200CGY,Philadelphia Flyers,PHI,0,CGY,3,7,10,21,10,27,3,6,9,35,15,7
2022-23,2/20/2023,202302200FLA,Florida Panthers,FLA,1,ANA,3,7,10,51,23,10,3,5,8,30,10,21
2022-23,2/20/2023,202302200NYR,Winnipeg Jets,WPG,0,NYR,4,8,12,21,18,10,1,1,2,51,20,9
2022-23,2/20/2023,202302200PIT,Pittsburgh Penguins,PIT,1,NYI,2,4,6,46,25,23,4,5,9,28,26,13
2022-23,2/20/2023,202302200SJS,San Jose Sharks,SJS,1,SEA,3,3,6,18,17,12,0,0,0,26,24,7
2022-23,2/19/2023,202302190ARI,Arizona Coyotes,ARI,1,CBJ,3,4,7,24,25,13,2,4,6,31,31,13
2022-23,2/19/2023,202302190CHI,Chicago Blackhawks,CHI,1,TOR,5,6,11,28,27,21,3,6,9,35,20,7
2022-23,2/19/2023,202302190COL,Colorado Avalanche,COL,1,EDM,6,10,16,42,16,21,5,10,15,40,27,15
2022-23,2/19/2023,202302190MIN,Minnesota Wild,MIN,1,NSH,4,6,10,35,19,17,3,5,8,26,24,17
2022-23,2/19/2023,202302190NJD,New Jersey Devils,NJD,1,WPG,4,7,11,29,13,18,2,4,6,25,9,11
2022-23,2/19/2023,202302190OTT,Ottawa Senators,OTT,1,STL,7,12,19,32,17,15,2,1,3,30,22,5
2022-23,2/19/2023,202302190ARI,Columbus Blue Jackets,CBJ,0,ARI,2,4,6,31,31,13,3,4,7,24,25,13
2022-23,2/19/2023,202302190CHI,Toronto Maple Leafs,TOR,0,CHI,3,6,9,35,20,7,5,6,11,28,27,21
2022-23,2/19/2023,202302190COL,Edmonton Oilers,EDM,0,COL,5,10,15,40,27,15,6,10,16,42,16,21
2022-23,2/19/2023,202302190MIN,Nashville Predators,NSH,0,MIN,3,5,8,26,24,17,4,6,10,35,19,17
2022-23,2/19/2023,202302190NJD,Winnipeg Jets,WPG,0,NJD,2,4,6,25,9,11,4,7,11,29,13,18
2022-23,2/19/2023,202302190OTT,St. Louis Blues,STL,0,OTT,2,1,3,30,22,5,7,12,19,32,17,15
2022-23,2/18/2023,202302180BOS,Boston Bruins,BOS,1,NYI,5,9,14,22,20,11,2,3,5,27,30,10
2022-23,2/18/2023,202302180CAR,Carolina Hurricanes,CAR,1,WSH,3,7,10,33,12,5,1,1,2,23,23,21
2022-23,2/18/2023,202302180CGY,Calgary Flames,CGY,1,NYR,3,5,8,28,21,10,2,4,6,20,26,13
2022-23,2/18/2023,202302180DAL,Columbus Blue Jackets,CBJ,0,DAL,4,7,11,31,23,15,1,0,1,27,11,17
2022-23,2/18/2023,202302180LAK,Arizona Coyotes,ARI,0,LAK,5,9,14,30,27,19,5,7,12,37,19,9
2022-23,2/18/2023,202302180NSH,Florida Panthers,FLA,0,NSH,3,3,6,32,21,14,7,8,15,24,27,8
2022-23,2/18/2023,202302180PIT,New Jersey Devils,NJD,0,PIT,5,8,13,43,21,20,2,3,5,31,25,10
2022-23,2/18/2023,202302180SEA,Detroit Red Wings,DET,0,SEA,2,4,6,23,10,15,4,7,11,26,11,13
2022-23,2/18/2023,202302180SJS,Buffalo Sabres,BUF,0,SJS,4,4,8,31,12,9,1,4,5,32,18,18
2022-23,2/18/2023,202302180STL,Colorado Avalanche,COL,0,STL,4,8,12,32,10,10,1,1,2,18,20,11
2022-23,2/18/2023,202302180TOR,Montreal Canadiens,MTL,0,TOR,1,2,3,27,25,12,5,8,13,41,28,14
2022-23,2/18/2023,202302180VAN,Philadelphia Flyers,PHI,0,VAN,2,3,5,35,19,9,6,11,17,22,27,19
2022-23,2/18/2023,202302180VEG,Tampa Bay Lightning,TBL,0,VEG,4,7,11,24,25,15,5,8,13,24,23,17
2022-23,2/18/2023,202302180BOS,New York Islanders,NYI,0,BOS,2,3,5,27,30,10,5,9,14,22,20,11
2022-23,2/18/2023,202302180CAR,Washington Capitals,WSH,0,CAR,1,1,2,23,23,21,3,7,10,33,12,5
2022-23,2/18/2023,202302180CGY,New York Rangers,NYR,0,CGY,2,4,6,20,26,13,3,5,8,28,21,10
2022-23,2/18/2023,202302180DAL,Dallas Stars,DAL,1,CBJ,1,0,1,27,11,17,4,7,11,31,23,15
2022-23,2/18/2023,202302180LAK,Los Angeles Kings,LAK,1,ARI,5,7,12,37,19,9,5,9,14,30,27,19
2022-23,2/18/2023,202302180NSH,Nashville Predators,NSH,1,FLA,7,8,15,24,27,8,3,3,6,32,21,14
2022-23,2/18/2023,202302180PIT,Pittsburgh Penguins,PIT,1,NJD,2,3,5,31,25,10,5,8,13,43,21,20
2022-23,2/18/2023,202302180SEA,Seattle Kraken,SEA,1,DET,4,7,11,26,11,13,2,4,6,23,10,15
2022-23,2/18/2023,202302180SJS,San Jose Sharks,SJS,1,BUF,1,4,5,32,18,18,4,4,8,31,12,9
2022-23,2/18/2023,202302180STL,St. Louis Blues,STL,1,COL,1,1,2,18,20,11,4,8,12,32,10,10
2022-23,2/18/2023,202302180TOR,Toronto Maple Leafs,TOR,1,MTL,5,8,13,41,28,14,1,2,3,27,25,12
2022-23,2/18/2023,202302180VAN,Vancouver Canucks,VAN,1,PHI,6,11,17,22,27,19,2,3,5,35,19,9
2022-23,2/18/2023,202302180VEG,Vegas Golden Knights,VEG,1,TBL,5,8,13,24,23,17,4,7,11,24,25,15
2022-23,2/17/2023,202302170ANA,Anaheim Ducks,ANA,1,LAK,3,5,8,25,13,15,6,11,17,41,10,9
2022-23,2/17/2023,202302170EDM,Edmonton Oilers,EDM,1,NYR,4,8,12,29,20,12,4,8,12,38,29,17
2022-23,2/17/2023,202302170MIN,Dallas Stars,DAL,0,MIN,1,2,3,30,13,13,1,2,3,32,14,22
2022-23,2/17/2023,202302170NYI,New York Islanders,NYI,1,PIT,5,9,14,28,28,17,4,8,12,43,18,12
2022-23,2/17/2023,202302170OTT,Chicago Blackhawks,CHI,0,OTT,4,5,9,32,30,15,3,5,8,28,35,6
2022-23,2/17/2023,202302170ANA,Los Angeles Kings,LAK,0,ANA,6,11,17,41,10,9,3,5,8,25,13,15
2022-23,2/17/2023,202302170EDM,New York Rangers,NYR,0,EDM,4,8,12,38,29,17,4,8,12,29,20,12
2022-23,2/17/2023,202302170MIN,Minnesota Wild,MIN,1,DAL,1,2,3,32,14,22,1,2,3,30,13,13
2022-23,2/17/2023,202302170NYI,Pittsburgh Penguins,PIT,0,NYI,4,8,12,43,18,12,5,9,14,28,28,17
2022-23,2/17/2023,202302170OTT,Ottawa Senators,OTT,1,CHI,3,5,8,28,35,6,4,5,9,32,30,15
2022-23,2/16/2023,202302160CAR,Carolina Hurricanes,CAR,1,MTL,6,10,16,36,10,5,2,4,6,22,15,13
2022-23,2/16/2023,202302160CBJ,Columbus Blue Jackets,CBJ,1,WPG,3,5,8,22,16,17,1,2,3,38,11,11
2022-23,2/16/2023,202302160CGY,Calgary Flames,CGY,1,DET,2,2,4,31,22,8,5,10,15,24,16,23
2022-23,2/16/2023,202302160NSH,Boston Bruins,BOS,0,NSH,4,7,11,27,19,11,0,0,0,27,34,14
2022-23,2/16/2023,202302160SEA,Philadelphia Flyers,PHI,0,SEA,2,3,5,18,14,17,6,8,14,30,11,19
2022-23,2/16/2023,202302160STL,New Jersey Devils,NJD,0,STL,2,4,6,36,15,16,4,8,12,35,17,20
2022-23,2/16/2023,202302160VEG,San Jose Sharks,SJS,0,VEG,1,2,3,24,19,19,2,3,5,38,24,16
2022-23,2/16/2023,202302160WSH,Florida Panthers,FLA,0,WSH,6,7,13,35,15,20,3,5,8,32,26,9
2022-23,2/16/2023,202302160CAR,Montreal Canadiens,MTL,0,CAR,2,4,6,22,15,13,6,10,16,36,10,5
2022-23,2/16/2023,202302160CBJ,Winnipeg Jets,WPG,0,CBJ,1,2,3,38,11,11,3,5,8,22,16,17
2022-23,2/16/2023,202302160CGY,Detroit Red Wings,DET,0,CGY,5,10,15,24,16,23,2,2,4,31,22,8
2022-23,2/16/2023,202302160NSH,Nashville Predators,NSH,1,BOS,0,0,0,27,34,14,4,7,11,27,19,11
2022-23,2/16/2023,202302160SEA,Seattle Kraken,SEA,1,PHI,6,8,14,30,11,19,2,3,5,18,14,17
2022-23,2/16/2023,202302160STL,St. Louis Blues,STL,1,NJD,4,8,12,35,17,20,2,4,6,36,15,16
2022-23,2/16/2023,202302160VEG,Vegas Golden Knights,VEG,1,SJS,2,3,5,38,24,16,1,2,3,24,19,19
2022-23,2/16/2023,202302160WSH,Washington Capitals,WSH,1,FLA,3,5,8,32,26,9,6,7,13,35,15,20
2022-23,2/15/2023,202302150ANA,Anaheim Ducks,ANA,1,BUF,3,4,7,19,7,11,7,14,21,44,7,10
2022-23,2/15/2023,202302150ARI,Arizona Coyotes,ARI,1,TBL,0,0,0,22,19,14,0,0,0,47,20,14
2022-23,2/15/2023,202302150EDM,Detroit Red Wings,DET,0,EDM,4,6,10,23,28,19,4,8,12,45,24,4
2022-23,2/15/2023,202302150MIN,Colorado Avalanche,COL,0,MIN,2,6,8,18,21,21,2,4,6,43,19,18
2022-23,2/15/2023,202302150TOR,Chicago Blackhawks,CHI,0,TOR,2,2,4,29,42,11,5,9,14,42,25,13
2022-23,2/15/2023,202302150VAN,New York Rangers,NYR,0,VAN,6,8,14,28,24,17,4,7,11,27,25,6
2022-23,2/15/2023,202302150ANA,Buffalo Sabres,BUF,0,ANA,7,14,21,44,7,10,3,4,7,19,7,11
2022-23,2/15/2023,202302150ARI,Tampa Bay Lightning,TBL,0,ARI,0,0,0,47,20,14,0,0,0,22,19,14
2022-23,2/15/2023,202302150EDM,Edmonton Oilers,EDM,1,DET,4,8,12,45,24,4,4,6,10,23,28,19
2022-23,2/15/2023,202302150MIN,Minnesota Wild,MIN,1,COL,2,4,6,43,19,18,2,6,8,18,21,21
2022-23,2/15/2023,202302150TOR,Toronto Maple Leafs,TOR,1,CHI,5,9,14,42,25,13,2,2,4,29,42,11
2022-23,2/15/2023,202302150VAN,Vancouver Canucks,VAN,1,NYR,4,7,11,27,25,6,6,8,14,28,24,17
2022-23,2/14/2023,202302140CBJ,Columbus Blue Jackets,CBJ,1,NJD,2,3,5,30,20,19,3,6,9,32,13,11
2022-23,2/14/2023,202302140COL,Colorado Avalanche,COL,1,TBL,2,3,5,43,30,19,3,4,7,35,31,11
2022-23,2/14/2023,202302140DAL,Boston Bruins,BOS,0,DAL,3,5,8,34,20,20,2,3,5,31,28,20
2022-23,2/14/2023,202302140MTL,Chicago Blackhawks,CHI,0,MTL,0,0,0,22,19,19,4,7,11,27,13,12
2022-23,2/14/2023,202302140NYI,New York Islanders,NYI,1,OTT,2,4,6,47,20,18,2,4,6,33,24,19
2022-23,2/14/2023,202302140SJS,Pittsburgh Penguins,PIT,0,SJS,3,6,9,26,18,12,1,0,1,38,15,11
2022-23,2/14/2023,202302140STL,Florida Panthers,FLA,0,STL,2,4,6,33,13,9,6,7,13,28,15,22
2022-23,2/14/2023,202302140WPG,Seattle Kraken,SEA,0,WPG,2,4,6,29,18,12,2,3,5,38,12,15
2022-23,2/14/2023,202302140WSH,Carolina Hurricanes,CAR,0,WSH,2,6,8,29,19,14,2,3,5,35,15,15
2022-23,2/14/2023,202302140CBJ,New Jersey Devils,NJD,0,CBJ,3,6,9,32,13,11,2,3,5,30,20,19
2022-23,2/14/2023,202302140COL,Tampa Bay Lightning,TBL,0,COL,3,4,7,35,31,11,2,3,5,43,30,19
2022-23,2/14/2023,202302140DAL,Dallas Stars,DAL,1,BOS,2,3,5,31,28,20,3,5,8,34,20,20
2022-23,2/14/2023,202302140MTL,Montreal Canadiens,MTL,1,CHI,4,7,11,27,13,12,0,0,0,22,19,19
2022-23,2/14/2023,202302140NYI,Ottawa Senators,OTT,0,NYI,2,4,6,33,24,19,2,4,6,47,20,18
2022-23,2/14/2023,202302140SJS,San Jose Sharks,SJS,1,PIT,1,0,1,38,15,11,3,6,9,26,18,12
2022-23,2/14/2023,202302140STL,St. Louis Blues,STL,1,FLA,6,7,13,28,15,22,2,4,6,33,13,9
2022-23,2/14/2023,202302140WPG,Winnipeg Jets,WPG,1,SEA,2,3,5,38,12,15,2,4,6,29,18,12
2022-23,2/14/2023,202302140WSH,Washington Capitals,WSH,1,CAR,2,3,5,35,15,15,2,6,8,29,19,14
2022-23,2/13/2023,202302130LAK,Buffalo Sabres,BUF,0,LAK,2,4,6,26,16,10,5,9,14,28,12,19
2022-23,2/13/2023,202302130MIN,Florida Panthers,FLA,0,MIN,1,2,3,32,14,14,1,2,3,28,10,22
2022-23,2/13/2023,202302130NSH,Arizona Coyotes,ARI,0,NSH,4,7,11,15,22,8,2,4,6,31,33,7
2022-23,2/13/2023,202302130OTT,Calgary Flames,CGY,0,OTT,3,5,8,36,20,9,4,8,12,24,35,26
2022-23,2/13/2023,202302130VAN,Detroit Red Wings,DET,0,VAN,6,11,17,23,16,13,0,2,2,26,21,9
2022-23,2/13/2023,202302130LAK,Los Angeles Kings,LAK,1,BUF,5,9,14,28,12,19,2,4,6,26,16,10
2022-23,2/13/2023,202302130MIN,Minnesota Wild,MIN,1,FLA,1,2,3,28,10,22,1,2,3,32,14,14
2022-23,2/13/2023,202302130NSH,Nashville Predators,NSH,1,ARI,2,4,6,31,33,7,4,7,11,15,22,8
2022-23,2/13/2023,202302130OTT,Ottawa Senators,OTT,1,CGY,4,8,12,24,35,26,3,5,8,36,20,9
2022-23,2/13/2023,202302130VAN,Vancouver Canucks,VAN,1,DET,0,2,2,26,21,9,6,11,17,23,16,13
2022-23,2/12/2023,202302120MTL,Edmonton Oilers,EDM,0,MTL,2,4,6,31,9,14,5,11,16,28,9,23
2022-23,2/12/2023,202302120PHI,Philadelphia Flyers,PHI,1,SEA,3,6,9,18,31,22,4,6,10,21,29,15
2022-23,2/12/2023,202302120VEG,Anaheim Ducks,ANA,0,VEG,2,2,4,22,15,10,6,13,19,37,20,12
2022-23,2/12/2023,202302120WSH,San Jose Sharks,SJS,0,WSH,3,7,10,31,20,16,1,2,3,21,23,24
2022-23,2/12/2023,202302120MTL,Montreal Canadiens,MTL,1,EDM,5,11,16,28,9,23,2,4,6,31,9,14
2022-23,2/12/2023,202302120PHI,Seattle Kraken,SEA,0,PHI,4,6,10,21,29,15,3,6,9,18,31,22
2022-23,2/12/2023,202302120VEG,Vegas Golden Knights,VEG,1,ANA,6,13,19,37,20,12,2,2,4,22,15,10
2022-23,2/12/2023,202302120WSH,Washington Capitals,WSH,1,SJS,1,2,3,21,23,24,3,7,10,31,20,16
2022-23,2/11/2023,202302110BOS,Boston Bruins,BOS,1,WSH,1,2,3,24,21,16,2,2,4,23,35,14
2022-23,2/11/2023,202302110BUF,Buffalo Sabres,BUF,1,CGY,2,4,6,23,8,11,7,13,20,36,21,18
2022-23,2/11/2023,202302110CAR,Carolina Hurricanes,CAR,1,NYR,2,2,4,28,28,7,6,10,16,19,23,15
2022-23,2/11/2023,202302110DAL,Dallas Stars,DAL,1,TBL,1,0,1,29,14,16,3,6,9,31,15,15
2022-23,2/11/2023,202302110DET,Detroit Red Wings,DET,1,VAN,5,10,15,25,17,22,2,3,5,30,16,9
2022-23,2/11/2023,202302110FLA,Colorado Avalanche,COL,0,FLA,5,8,13,48,7,16,3,5,8,45,17,11
2022-23,2/11/2023,202302110LAK,Los Angeles Kings,LAK,1,PIT,6,11,17,31,16,21,0,0,0,24,18,11
2022-23,2/11/2023,202302110MIN,Minnesota Wild,MIN,1,NJD,2,4,6,24,32,12,2,4,6,29,20,22
2022-23,2/11/2023,202302110MTL,Montreal Canadiens,MTL,1,NYI,4,7,11,30,21,22,3,6,9,28,15,12
2022-23,2/11/2023,202302110OTT,Edmonton Oilers,EDM,0,OTT,6,9,15,40,25,13,3,5,8,26,30,17
2022-23,2/11/2023,202302110PHI,Nashville Predators,NSH,0,PHI,2,4,6,24,41,12,1,2,3,23,31,28
2022-23,2/11/2023,202302110STL,Arizona Coyotes,ARI,0,STL,5,10,15,26,11,10,6,12,18,37,22,13
2022-23,2/11/2023,202302110TOR,Columbus Blue Jackets,CBJ,0,TOR,4,7,11,39,38,18,3,5,8,29,21,19
2022-23,2/11/2023,202302110WPG,Chicago Blackhawks,CHI,0,WPG,1,2,3,32,24,18,4,6,10,27,12,18
2022-23,2/11/2023,202302110BOS,Washington Capitals,WSH,0,BOS,2,2,4,23,35,14,1,2,3,24,21,16
2022-23,2/11/2023,202302110BUF,Calgary Flames,CGY,0,BUF,7,13,20,36,21,18,2,4,6,23,8,11
2022-23,2/11/2023,202302110CAR,New York Rangers,NYR,0,CAR,6,10,16,19,23,15,2,2,4,28,28,7
2022-23,2/11/2023,202302110DAL,Tampa Bay Lightning,TBL,0,DAL,3,6,9,31,15,15,1,0,1,29,14,16
2022-23,2/11/2023,202302110DET,Vancouver Canucks,VAN,0,DET,2,3,5,30,16,9,5,10,15,25,17,22
2022-23,2/11/2023,202302110FLA,Florida Panthers,FLA,1,COL,3,5,8,45,17,11,5,8,13,48,7,16
2022-23,2/11/2023,202302110LAK,Pittsburgh Penguins,PIT,0,LAK,0,0,0,24,18,11,6,11,17,31,16,21
2022-23,2/11/2023,202302110MIN,New Jersey Devils,NJD,0,MIN,2,4,6,29,20,22,2,4,6,24,32,12
2022-23,2/11/2023,202302110MTL,New York Islanders,NYI,0,MTL,3,6,9,28,15,12,4,7,11,30,21,22
2022-23,2/11/2023,202302110OTT,Ottawa Senators,OTT,1,EDM,3,5,8,26,30,17,6,9,15,40,25,13
2022-23,2/11/2023,202302110PHI,Philadelphia Flyers,PHI,1,NSH,1,2,3,23,31,28,2,4,6,24,41,12
2022-23,2/11/2023,202302110STL,St. Louis Blues,STL,1,ARI,6,12,18,37,22,13,5,10,15,26,11,10
2022-23,2/11/2023,202302110TOR,Toronto Maple Leafs,TOR,1,CBJ,3,5,8,29,21,19,4,7,11,39,38,18
2022-23,2/11/2023,202302110WPG,Winnipeg Jets,WPG,1,CHI,4,6,10,27,12,18,1,2,3,32,24,18
2022-23,2/10/2023,202302100ANA,Anaheim Ducks,ANA,1,PIT,3,5,8,26,9,14,6,8,14,57,7,6
2022-23,2/10/2023,202302100CBJ,Columbus Blue Jackets,CBJ,1,TOR,0,0,0,30,14,18,3,5,8,41,6,14
2022-23,2/10/2023,202302100CHI,Arizona Coyotes,ARI,0,CHI,3,6,9,22,20,8,4,7,11,44,27,12
2022-23,2/10/2023,202302100NYR,New York Rangers,NYR,1,SEA,6,9,15,28,30,22,3,5,8,29,23,10
2022-23,2/10/2023,202302100ANA,Pittsburgh Penguins,PIT,0,ANA,6,8,14,57,7,6,3,5,8,26,9,14
2022-23,2/10/2023,202302100CBJ,Toronto Maple Leafs,TOR,0,CBJ,3,5,8,41,6,14,0,0,0,30,14,18
2022-23,2/10/2023,202302100CHI,Chicago Blackhawks,CHI,1,ARI,4,7,11,44,27,12,3,6,9,22,20,8
2022-23,2/10/2023,202302100NYR,Seattle Kraken,SEA,0,NYR,3,5,8,29,23,10,6,9,15,28,30,22
2022-23,2/9/2023,202302090DET,Calgary Flames,CGY,0,DET,1,2,3,34,11,11,2,4,6,17,20,17
2022-23,2/9/2023,202302090FLA,Florida Panthers,FLA,1,SJS,2,4,6,38,27,12,1,1,2,32,14,15
2022-23,2/9/2023,202302090MIN,Minnesota Wild,MIN,1,VEG,1,2,3,28,37,13,5,6,11,29,12,16
2022-23,2/9/2023,202302090NJD,New Jersey Devils,NJD,1,SEA,3,6,9,27,22,27,1,2,3,34,15,11
2022-23,2/9/2023,202302090NYI,New York Islanders,NYI,1,VAN,5,7,12,28,26,9,6,10,16,33,21,13
2022-23,2/9/2023,202302090PHI,Edmonton Oilers,EDM,0,PHI,1,2,3,35,13,17,1,2,3,34,18,8
2022-23,2/9/2023,202302090TBL,Colorado Avalanche,COL,0,TBL,0,0,0,28,32,16,5,9,14,32,30,17
2022-23,2/9/2023,202302090DET,Detroit Red Wings,DET,1,CGY,2,4,6,17,20,17,1,2,3,34,11,11
2022-23,2/9/2023,202302090FLA,San Jose Sharks,SJS,0,FLA,1,1,2,32,14,15,2,4,6,38,27,12
2022-23,2/9/2023,202302090MIN,Vegas Golden Knights,VEG,0,MIN,5,6,11,29,12,16,1,2,3,28,37,13
2022-23,2/9/2023,202302090NJD,Seattle Kraken,SEA,0,NJD,1,2,3,34,15,11,3,6,9,27,22,27
2022-23,2/9/2023,202302090NYI,Vancouver Canucks,VAN,0,NYI,6,10,16,33,21,13,5,7,12,28,26,9
2022-23,2/9/2023,202302090PHI,Philadelphia Flyers,PHI,1,EDM,1,2,3,34,18,8,1,2,3,35,13,17
2022-23,2/9/2023,202302090TBL,Tampa Bay Lightning,TBL,1,COL,5,9,14,32,30,17,0,0,0,28,32,16
2022-23,2/8/2023,202302080DAL,Dallas Stars,DAL,1,MIN,4,7,11,37,14,18,1,2,3,39,24,16
2022-23,2/8/2023,202302080NYR,New York Rangers,NYR,1,VAN,4,8,12,21,23,10,3,4,7,23,18,12
2022-23,2/8/2023,202302080DAL,Minnesota Wild,MIN,0,DAL,1,2,3,39,24,16,4,7,11,37,14,18
2022-23,2/8/2023,202302080NYR,Vancouver Canucks,VAN,0,NYR,3,4,7,23,18,12,4,8,12,21,23,10
2022-23,2/7/2023,202302070CHI,Anaheim Ducks,ANA,0,CHI,3,5,8,25,13,14,2,3,5,29,21,9
2022-23,2/7/2023,202302070DET,Detroit Red Wings,DET,1,EDM,2,4,6,32,16,9,5,8,13,27,20,12
2022-23,2/7/2023,202302070NSH,Nashville Predators,NSH,1,VEG,1,2,3,17,23,16,4,5,9,28,14,16
2022-23,2/7/2023,202302070NYI,New York Islanders,NYI,1,SEA,4,6,10,27,25,16,0,0,0,32,31,13
2022-23,2/7/2023,202302070PIT,Colorado Avalanche,COL,0,PIT,1,2,3,39,19,24,2,4,6,37,34,15
2022-23,2/7/2023,202302070TBL,San Jose Sharks,SJS,0,TBL,4,7,11,21,29,21,3,5,8,37,20,7
2022-23,2/7/2023,202302070CHI,Chicago Blackhawks,CHI,1,ANA,2,3,5,29,21,9,3,5,8,25,13,14
2022-23,2/7/2023,202302070DET,Edmonton Oilers,EDM,0,DET,5,8,13,27,20,12,2,4,6,32,16,9
2022-23,2/7/2023,202302070NSH,Vegas Golden Knights,VEG,0,NSH,4,5,9,28,14,16,1,2,3,17,23,16
2022-23,2/7/2023,202302070NYI,Seattle Kraken,SEA,0,NYI,0,0,0,32,31,13,4,6,10,27,25,16
2022-23,2/7/2023,202302070PIT,Pittsburgh Penguins,PIT,1,COL,2,4,6,37,34,15,1,2,3,39,19,24
2022-23,2/7/2023,202302070TBL,Tampa Bay Lightning,TBL,1,SJS,3,5,8,37,20,7,4,7,11,21,29,21
2022-23,2/6/2023,202302060ARI,Arizona Coyotes,ARI,1,MIN,3,5,8,30,14,11,2,4,6,35,26,17
2022-23,2/6/2023,202302060DAL,Anaheim Ducks,ANA,0,DAL,2,3,5,34,11,20,2,4,6,41,13,10
2022-23,2/6/2023,202302060FLA,Florida Panthers,FLA,1,TBL,6,10,16,48,19,12,1,2,3,33,13,17
2022-23,2/6/2023,202302060NJD,New Jersey Devils,NJD,1,VAN,5,8,13,34,15,18,4,7,11,30,29,13
2022-23,2/6/2023,202302060NYR,Calgary Flames,CGY,0,NYR,3,7,10,29,24,10,5,7,12,33,24,13
2022-23,2/6/2023,202302060PHI,New York Islanders,NYI,0,PHI,2,3,5,29,26,18,1,2,3,23,29,16
2022-23,2/6/2023,202302060ARI,Minnesota Wild,MIN,0,ARI,2,4,6,35,26,17,3,5,8,30,14,11
2022-23,2/6/2023,202302060DAL,Dallas Stars,DAL,1,ANA,2,4,6,41,13,10,2,3,5,34,11,20
2022-23,2/6/2023,202302060FLA,Tampa Bay Lightning,TBL,0,FLA,1,2,3,33,13,17,6,10,16,48,19,12
2022-23,2/6/2023,202302060NJD,Vancouver Canucks,VAN,0,NJD,4,7,11,30,29,13,5,8,13,34,15,18
2022-23,2/6/2023,202302060NYR,New York Rangers,NYR,1,CGY,5,7,12,33,24,13,3,7,10,29,24,10
2022-23,2/6/2023,202302060PHI,Philadelphia Flyers,PHI,1,NYI,1,2,3,23,29,16,2,3,5,29,26,18
2022-23,2/1/2023,202302010BUF,Buffalo Sabres,BUF,1,CAR,1,1,2,30,8,16,4,9,13,28,10,10
2022-23,2/1/2023,202302010TOR,Boston Bruins,BOS,0,TOR,5,8,13,27,29,20,2,3,5,35,22,9
2022-23,2/1/2023,202302010BUF,Carolina Hurricanes,CAR,0,BUF,4,9,13,28,10,10,1,1,2,30,8,16
2022-23,2/1/2023,202302010TOR,Toronto Maple Leafs,TOR,1,BOS,2,3,5,35,22,9,5,8,13,27,29,20
2022-23,1/31/2023,202301310CAR,Carolina Hurricanes,CAR,1,LAK,4,8,12,26,21,7,4,6,10,20,10,14
2022-23,1/31/2023,202301310CBJ,Columbus Blue Jackets,CBJ,1,WSH,3,2,5,31,27,15,4,7,11,33,14,22
2022-23,1/31/2023,202301310MTL,Montreal Canadiens,MTL,1,OTT,4,7,11,32,14,13,5,10,15,28,19,13
2022-23,1/31/2023,202301310CAR,Los Angeles Kings,LAK,0,CAR,4,6,10,20,10,14,4,8,12,26,21,7
2022-23,1/31/2023,202301310CBJ,Washington Capitals,WSH,0,CBJ,4,7,11,33,14,22,3,2,5,31,27,15
2022-23,1/31/2023,202301310MTL,Ottawa Senators,OTT,0,MTL,5,10,15,28,19,13,4,7,11,32,14,13
2022-23,1/30/2023,202301300WPG,St. Louis Blues,STL,0,WPG,2,2,4,24,21,17,4,6,10,30,21,10
2022-23,1/30/2023,202301300WPG,Winnipeg Jets,WPG,1,STL,4,6,10,30,21,10,2,2,4,24,21,17
2022-23,1/29/2023,202301290CAR,Boston Bruins,BOS,0,CAR,1,2,3,23,15,8,3,3,6,35,15,7
2022-23,1/29/2023,202301290TOR,Toronto Maple Leafs,TOR,1,WSH,5,10,15,27,25,14,1,2,3,22,36,8
2022-23,1/29/2023,202301290CAR,Carolina Hurricanes,CAR,1,BOS,3,3,6,35,15,7,1,2,3,23,15,8
2022-23,1/29/2023,202301290TOR,Washington Capitals,WSH,0,TOR,1,2,3,22,36,8,5,10,15,27,25,14
2022-23,1/28/2023,202301280ANA,Anaheim Ducks,ANA,1,ARI,2,3,5,45,8,11,0,2,2,29,9,13
2022-23,1/28/2023,202301280COL,Colorado Avalanche,COL,1,STL,4,6,10,29,13,13,2,2,4,26,23,14
2022-23,1/28/2023,202301280EDM,Chicago Blackhawks,CHI,0,EDM,2,5,7,27,27,17,7,12,19,43,21,17
2022-23,1/28/2023,202301280FLA,Boston Bruins,BOS,0,FLA,3,1,4,35,13,19,4,7,11,37,24,16
2022-23,1/28/2023,202301280MIN,Buffalo Sabres,BUF,0,MIN,2,2,4,31,5,11,2,4,6,35,24,15
2022-23,1/28/2023,202301280NYI,New York Islanders,NYI,1,VEG,2,4,6,35,22,15,1,1,2,39,23,21
2022-23,1/28/2023,202301280OTT,Montreal Canadiens,MTL,0,OTT,0,0,0,27,40,12,4,4,8,33,21,17
2022-23,1/28/2023,202301280PIT,Pittsburgh Penguins,PIT,1,SJS,4,6,10,41,35,19,6,10,16,31,37,24
2022-23,1/28/2023,202301280SEA,Columbus Blue Jackets,CBJ,0,SEA,1,1,2,24,12,12,3,5,8,31,15,14
2022-23,1/28/2023,202301280TBL,Los Angeles Kings,LAK,0,TBL,2,3,5,27,28,16,5,8,13,25,26,10
2022-23,1/28/2023,202301280WPG,Philadelphia Flyers,PHI,0,WPG,3,7,10,31,9,16,0,0,0,37,21,14
2022-23,1/28/2023,202301280ANA,Arizona Coyotes,ARI,0,ANA,0,2,2,29,9,13,2,3,5,45,8,11
2022-23,1/28/2023,202301280COL,St. Louis Blues,STL,0,COL,2,2,4,26,23,14,4,6,10,29,13,13
2022-23,1/28/2023,202301280EDM,Edmonton Oilers,EDM,1,CHI,7,12,19,43,21,17,2,5,7,27,27,17
2022-23,1/28/2023,202301280FLA,Florida Panthers,FLA,1,BOS,4,7,11,37,24,16,3,1,4,35,13,19
2022-23,1/28/2023,202301280MIN,Minnesota Wild,MIN,1,BUF,2,4,6,35,24,15,2,2,4,31,5,11
2022-23,1/28/2023,202301280NYI,Vegas Golden Knights,VEG,0,NYI,1,1,2,39,23,21,2,4,6,35,22,15
2022-23,1/28/2023,202301280OTT,Ottawa Senators,OTT,1,MTL,4,4,8,33,21,17,0,0,0,27,40,12
2022-23,1/28/2023,202301280PIT,San Jose Sharks,SJS,0,PIT,6,10,16,31,37,24,4,6,10,41,35,19
2022-23,1/28/2023,202301280SEA,Seattle Kraken,SEA,1,CBJ,3,5,8,31,15,14,1,1,2,24,12,12
2022-23,1/28/2023,202301280TBL,Tampa Bay Lightning,TBL,1,LAK,5,8,13,25,26,10,2,3,5,27,28,16
2022-23,1/28/2023,202301280WPG,Winnipeg Jets,WPG,1,PHI,0,0,0,37,21,14,3,7,10,31,9,16
2022-23,1/27/2023,202301270CAR,Carolina Hurricanes,CAR,1,SJS,5,8,13,35,13,12,4,5,9,28,20,15
2022-23,1/27/2023,202301270DAL,Dallas Stars,DAL,1,NJD,2,4,6,35,11,12,3,4,7,29,14,24
2022-23,1/27/2023,202301270FLA,Florida Panthers,FLA,1,LAK,3,5,8,47,14,13,4,5,9,33,17,19
2022-23,1/27/2023,202301270NYI,Detroit Red Wings,DET,0,NYI,0,0,0,23,21,12,2,4,6,28,23,9
2022-23,1/27/2023,202301270NYR,New York Rangers,NYR,1,VEG,4,5,9,40,27,7,0,2,2,30,31,8
2022-23,1/27/2023,202301270SEA,Calgary Flames,CGY,0,SEA,5,10,15,37,18,15,2,4,6,30,18,15
2022-23,1/27/2023,202301270TOR,Ottawa Senators,OTT,0,TOR,5,7,12,28,19,11,2,4,6,33,22,7
2022-23,1/27/2023,202301270VAN,Columbus Blue Jackets,CBJ,0,VAN,2,4,6,22,18,9,5,9,14,32,23,9
2022-23,1/27/2023,202301270CAR,San Jose Sharks,SJS,0,CAR,4,5,9,28,20,15,5,8,13,35,13,12
2022-23,1/27/2023,202301270DAL,New Jersey Devils,NJD,0,DAL,3,4,7,29,14,24,2,4,6,35,11,12
2022-23,1/27/2023,202301270FLA,Los Angeles Kings,LAK,0,FLA,4,5,9,33,17,19,3,5,8,47,14,13
2022-23,1/27/2023,202301270NYI,New York Islanders,NYI,1,DET,2,4,6,28,23,9,0,0,0,23,21,12
2022-23,1/27/2023,202301270NYR,Vegas Golden Knights,VEG,0,NYR,0,2,2,30,31,8,4,5,9,40,27,7
2022-23,1/27/2023,202301270SEA,Seattle Kraken,SEA,1,CGY,2,4,6,30,18,15,5,10,15,37,18,15
2022-23,1/27/2023,202301270TOR,Toronto Maple Leafs,TOR,1,OTT,2,4,6,33,22,7,5,7,12,28,19,11
2022-23,1/27/2023,202301270VAN,Vancouver Canucks,VAN,1,CBJ,5,9,14,32,23,9,2,4,6,22,18,9
2022-23,1/26/2023,202301260ARI,Arizona Coyotes,ARI,1,STL,5,4,9,22,19,14,0,0,0,29,19,10
2022-23,1/26/2023,202301260CGY,Calgary Flames,CGY,1,CHI,1,2,3,30,12,6,5,8,13,29,15,18
2022-23,1/26/2023,202301260COL,Anaheim Ducks,ANA,0,COL,5,6,11,31,13,14,3,5,8,43,13,11
2022-23,1/26/2023,202301260MIN,Minnesota Wild,MIN,1,PHI,3,6,9,23,19,16,2,3,5,28,17,20
2022-23,1/26/2023,202301260MTL,Detroit Red Wings,DET,0,MTL,4,6,10,42,25,19,3,4,7,21,25,22
2022-23,1/26/2023,202301260NSH,New Jersey Devils,NJD,0,NSH,4,6,10,39,19,15,6,8,14,37,27,14
2022-23,1/26/2023,202301260TBL,Boston Bruins,BOS,0,TBL,2,3,5,34,23,11,3,6,9,35,30,9
2022-23,1/26/2023,202301260WPG,Buffalo Sabres,BUF,0,WPG,3,6,9,36,10,15,2,4,6,20,17,12
2022-23,1/26/2023,202301260WSH,Pittsburgh Penguins,PIT,0,WSH,2,4,6,37,23,20,2,4,6,44,17,17
2022-23,1/26/2023,202301260ARI,St. Louis Blues,STL,0,ARI,0,0,0,29,19,10,5,4,9,22,19,14
2022-23,1/26/2023,202301260CGY,Chicago Blackhawks,CHI,0,CGY,5,8,13,29,15,18,1,2,3,30,12,6
2022-23,1/26/2023,202301260COL,Colorado Avalanche,COL,1,ANA,3,5,8,43,13,11,5,6,11,31,13,14
2022-23,1/26/2023,202301260MIN,Philadelphia Flyers,PHI,0,MIN,2,3,5,28,17,20,3,6,9,23,19,16
2022-23,1/26/2023,202301260MTL,Montreal Canadiens,MTL,1,DET,3,4,7,21,25,22,4,6,10,42,25,19
2022-23,1/26/2023,202301260NSH,Nashville Predators,NSH,1,NJD,6,8,14,37,27,14,4,6,10,39,19,15
2022-23,1/26/2023,202301260TBL,Tampa Bay Lightning,TBL,1,BOS,3,6,9,35,30,9,2,3,5,34,23,11
2022-23,1/26/2023,202301260WPG,Winnipeg Jets,WPG,1,BUF,2,4,6,20,17,12,3,6,9,36,10,15
2022-23,1/26/2023,202301260WSH,Washington Capitals,WSH,1,PIT,2,4,6,44,17,17,2,4,6,37,23,20
2022-23,1/25/2023,202301250DAL,Carolina Hurricanes,CAR,0,DAL,3,4,7,22,18,8,2,0,2,21,31,18
2022-23,1/25/2023,202301250EDM,Columbus Blue Jackets,CBJ,0,EDM,3,6,9,27,29,20,2,2,4,36,19,20
2022-23,1/25/2023,202301250OTT,New York Islanders,NYI,0,OTT,1,2,3,34,21,19,2,4,6,33,17,9
2022-23,1/25/2023,202301250SEA,Seattle Kraken,SEA,1,VAN,6,11,17,35,8,15,1,2,3,20,19,18
2022-23,1/25/2023,202301250TOR,New York Rangers,NYR,0,TOR,2,2,4,28,35,15,3,5,8,34,14,9
2022-23,1/25/2023,202301250DAL,Dallas Stars,DAL,1,CAR,2,0,2,21,31,18,3,4,7,22,18,8
2022-23,1/25/2023,202301250EDM,Edmonton Oilers,EDM,1,CBJ,2,2,4,36,19,20,3,6,9,27,29,20
2022-23,1/25/2023,202301250OTT,Ottawa Senators,OTT,1,NYI,2,4,6,33,17,9,1,2,3,34,21,19
2022-23,1/25/2023,202301250SEA,Vancouver Canucks,VAN,0,SEA,1,2,3,20,19,18,6,11,17,35,8,15
2022-23,1/25/2023,202301250TOR,Toronto Maple Leafs,TOR,1,NYR,3,5,8,34,14,9,2,2,4,28,35,15
2022-23,1/24/2023,202301240ARI,Anaheim Ducks,ANA,0,ARI,5,8,13,41,16,19,2,2,4,36,15,11
2022-23,1/24/2023,202301240COL,Colorado Avalanche,COL,1,WSH,3,6,9,25,17,16,2,3,5,38,22,14
2022-23,1/24/2023,202301240DET,Detroit Red Wings,DET,1,SJS,3,3,6,35,19,23,2,4,6,30,12,9
2022-23,1/24/2023,202301240MTL,Boston Bruins,BOS,0,MTL,2,6,8,23,13,11,2,3,5,20,13,16
2022-23,1/24/2023,202301240NJD,New Jersey Devils,NJD,1,VEG,3,5,8,36,17,18,2,4,6,28,19,20
2022-23,1/24/2023,202301240NSH,Nashville Predators,NSH,1,WPG,2,3,5,41,29,14,1,2,3,31,19,10
2022-23,1/24/2023,202301240PHI,Los Angeles Kings,LAK,0,PHI,4,5,9,36,13,6,2,6,8,28,26,16
2022-23,1/24/2023,202301240PIT,Florida Panthers,FLA,0,PIT,6,9,15,39,27,28,7,14,21,49,27,14
2022-23,1/24/2023,202301240STL,Buffalo Sabres,BUF,0,STL,5,8,13,31,13,5,3,6,9,27,18,6
2022-23,1/24/2023,202301240TBL,Minnesota Wild,MIN,0,TBL,2,3,5,35,26,16,4,7,11,39,26,14
2022-23,1/24/2023,202301240VAN,Chicago Blackhawks,CHI,0,VAN,2,4,6,13,19,16,4,9,13,46,23,8
2022-23,1/24/2023,202301240ARI,Arizona Coyotes,ARI,1,ANA,2,2,4,36,15,11,5,8,13,41,16,19
2022-23,1/24/2023,202301240COL,Washington Capitals,WSH,0,COL,2,3,5,38,22,14,3,6,9,25,17,16
2022-23,1/24/2023,202301240DET,San Jose Sharks,SJS,0,DET,2,4,6,30,12,9,3,3,6,35,19,23
2022-23,1/24/2023,202301240MTL,Montreal Canadiens,MTL,1,BOS,2,3,5,20,13,16,2,6,8,23,13,11
2022-23,1/24/2023,202301240NJD,Vegas Golden Knights,VEG,0,NJD,2,4,6,28,19,20,3,5,8,36,17,18
2022-23,1/24/2023,202301240NSH,Winnipeg Jets,WPG,0,NSH,1,2,3,31,19,10,2,3,5,41,29,14
2022-23,1/24/2023,202301240PHI,Philadelphia Flyers,PHI,1,LAK,2,6,8,28,26,16,4,5,9,36,13,6
2022-23,1/24/2023,202301240PIT,Pittsburgh Penguins,PIT,1,FLA,7,14,21,49,27,14,6,9,15,39,27,28
2022-23,1/24/2023,202301240STL,St. Louis Blues,STL,1,BUF,3,6,9,27,18,6,5,8,13,31,13,5
2022-23,1/24/2023,202301240TBL,Tampa Bay Lightning,TBL,1,MIN,4,7,11,39,26,14,2,3,5,35,26,16
2022-23,1/24/2023,202301240VAN,Vancouver Canucks,VAN,1,CHI,4,9,13,46,23,8,2,4,6,13,19,16
2022-23,1/23/2023,202301230CGY,Columbus Blue Jackets,CBJ,0,CGY,3,6,9,25,11,19,4,6,10,45,17,9
2022-23,1/23/2023,202301230DAL,Buffalo Sabres,BUF,0,DAL,3,5,8,25,13,12,2,3,5,31,26,15
2022-23,1/23/2023,202301230NYR,Florida Panthers,FLA,0,NYR,2,4,6,35,16,13,6,12,18,24,22,17
2022-23,1/23/2023,202301230TOR,New York Islanders,NYI,0,TOR,2,4,6,31,46,12,5,6,11,39,30,25
2022-23,1/23/2023,202301230CGY,Calgary Flames,CGY,1,CBJ,4,6,10,45,17,9,3,6,9,25,11,19
2022-23,1/23/2023,202301230DAL,Dallas Stars,DAL,1,BUF,2,3,5,31,26,15,3,5,8,25,13,12
2022-23,1/23/2023,202301230NYR,New York Rangers,NYR,1,FLA,6,12,18,24,22,17,2,4,6,35,16,13
2022-23,1/23/2023,202301230TOR,Toronto Maple Leafs,TOR,1,NYI,5,6,11,39,30,25,2,4,6,31,46,12
2022-23,1/22/2023,202301220ARI,Arizona Coyotes,ARI,1,VEG,4,7,11,19,26,14,0,2,2,35,25,11
2022-23,1/22/2023,202301220BOS,Boston Bruins,BOS,1,SJS,4,7,11,19,24,8,0,0,0,17,30,6
2022-23,1/22/2023,202301220CHI,Chicago Blackhawks,CHI,1,LAK,1,2,3,16,27,7,2,4,6,27,16,13
2022-23,1/22/2023,202301220NJD,New Jersey Devils,NJD,1,PIT,2,3,5,25,8,13,1,2,3,26,16,19
2022-23,1/22/2023,202301220PHI,Philadelphia Flyers,PHI,1,WPG,3,6,9,30,27,12,4,9,13,27,25,15
2022-23,1/22/2023,202301220ARI,Vegas Golden Knights,VEG,0,ARI,0,2,2,35,25,11,4,7,11,19,26,14
2022-23,1/22/2023,202301220BOS,San Jose Sharks,SJS,0,BOS,0,0,0,17,30,6,4,7,11,19,24,8
2022-23,1/22/2023,202301220CHI,Los Angeles Kings,LAK,0,CHI,2,4,6,27,16,13,1,2,3,16,27,7
2022-23,1/22/2023,202301220NJD,Pittsburgh Penguins,PIT,0,NJD,1,2,3,26,16,19,2,3,5,25,8,13
2022-23,1/22/2023,202301220PHI,Winnipeg Jets,WPG,0,PHI,4,9,13,27,25,15,3,6,9,30,27,12
2022-23,1/21/2023,202301210BUF,Anaheim Ducks,ANA,0,BUF,3,4,7,33,15,7,6,11,17,39,13,11
2022-23,1/21/2023,202301210CBJ,Columbus Blue Jackets,CBJ,1,SJS,5,9,14,29,23,4,3,4,7,24,12,11
2022-23,1/21/2023,202301210CGY,Calgary Flames,CGY,1,TBL,6,12,18,40,21,14,3,4,7,24,20,18
2022-23,1/21/2023,202301210DAL,Arizona Coyotes,ARI,0,DAL,0,0,0,28,22,6,4,8,12,39,21,9
2022-23,1/21/2023,202301210DET,Detroit Red Wings,DET,1,PHI,1,2,3,31,19,13,2,2,4,24,24,30
2022-23,1/21/2023,202301210FLA,Florida Panthers,FLA,1,MIN,5,8,13,27,27,13,3,6,9,32,24,16
2022-23,1/21/2023,202301210MTL,Montreal Canadiens,MTL,1,TOR,3,5,8,31,31,22,2,4,6,38,13,14
2022-23,1/21/2023,202301210NSH,Los Angeles Kings,LAK,0,NSH,3,5,8,33,25,14,5,10,15,28,43,16
2022-23,1/21/2023,202301210NYI,Carolina Hurricanes,CAR,0,NYI,5,5,10,24,16,13,2,1,3,31,21,20
2022-23,1/21/2023,202301210OTT,Ottawa Senators,OTT,1,WPG,1,1,2,25,25,11,5,10,15,30,13,16
2022-23,1/21/2023,202301210SEA,Colorado Avalanche,COL,0,SEA,1,2,3,27,24,13,1,0,1,27,26,20
2022-23,1/21/2023,202301210STL,Chicago Blackhawks,CHI,0,STL,5,9,14,17,33,14,3,6,9,30,17,11
2022-23,1/21/2023,202301210VAN,Edmonton Oilers,EDM,0,VAN,4,6,10,29,16,12,2,4,6,27,18,7
2022-23,1/21/2023,202301210VEG,Vegas Golden Knights,VEG,1,WSH,6,10,16,26,28,17,2,4,6,22,40,9
2022-23,1/21/2023,202301210BUF,Buffalo Sabres,BUF,1,ANA,6,11,17,39,13,11,3,4,7,33,15,7
2022-23,1/21/2023,202301210CBJ,San Jose Sharks,SJS,0,CBJ,3,4,7,24,12,11,5,9,14,29,23,4
2022-23,1/21/2023,202301210CGY,Tampa Bay Lightning,TBL,0,CGY,3,4,7,24,20,18,6,12,18,40,21,14
2022-23,1/21/2023,202301210DAL,Dallas Stars,DAL,1,ARI,4,8,12,39,21,9,0,0,0,28,22,6
2022-23,1/21/2023,202301210DET,Philadelphia Flyers,PHI,0,DET,2,2,4,24,24,30,1,2,3,31,19,13
2022-23,1/21/2023,202301210FLA,Minnesota Wild,MIN,0,FLA,3,6,9,32,24,16,5,8,13,27,27,13
2022-23,1/21/2023,202301210MTL,Toronto Maple Leafs,TOR,0,MTL,2,4,6,38,13,14,3,5,8,31,31,22
2022-23,1/21/2023,202301210NSH,Nashville Predators,NSH,1,LAK,5,10,15,28,43,16,3,5,8,33,25,14
2022-23,1/21/2023,202301210NYI,New York Islanders,NYI,1,CAR,2,1,3,31,21,20,5,5,10,24,16,13
2022-23,1/21/2023,202301210OTT,Winnipeg Jets,WPG,0,OTT,5,10,15,30,13,16,1,1,2,25,25,11
2022-23,1/21/2023,202301210SEA,Seattle Kraken,SEA,1,COL,1,0,1,27,26,20,1,2,3,27,24,13
2022-23,1/21/2023,202301210STL,St. Louis Blues,STL,1,CHI,3,6,9,30,17,11,5,9,14,17,33,14
2022-23,1/21/2023,202301210VAN,Vancouver Canucks,VAN,1,EDM,2,4,6,27,18,7,4,6,10,29,16,12
2022-23,1/21/2023,202301210VEG,Washington Capitals,WSH,0,VEG,2,4,6,22,40,9,6,10,16,26,28,17
2022-23,1/20/2023,202301200PIT,Ottawa Senators,OTT,0,PIT,1,1,2,35,26,14,4,5,9,44,29,18
2022-23,1/20/2023,202301200VAN,Colorado Avalanche,COL,0,VAN,3,6,9,28,10,7,1,2,3,26,24,10
2022-23,1/20/2023,202301200PIT,Pittsburgh Penguins,PIT,1,OTT,4,5,9,44,29,18,1,1,2,35,26,14
2022-23,1/20/2023,202301200VAN,Vancouver Canucks,VAN,1,COL,1,2,3,26,24,10,3,6,9,28,10,7
2022-23,1/19/2023,202301190ARI,Arizona Coyotes,ARI,1,WSH,0,0,0,25,16,16,4,8,12,33,21,8
2022-23,1/19/2023,202301190BUF,Buffalo Sabres,BUF,1,NYI,3,6,9,45,9,10,2,2,4,26,23,27
2022-23,1/19/2023,202301190CAR,Carolina Hurricanes,CAR,1,MIN,5,8,13,28,9,15,2,4,6,31,14,18
2022-23,1/19/2023,202301190CBJ,Anaheim Ducks,ANA,0,CBJ,5,10,15,33,15,12,3,4,7,32,15,11
2022-23,1/19/2023,202301190EDM,Edmonton Oilers,EDM,1,TBL,5,8,13,34,23,10,3,6,9,31,27,19
2022-23,1/19/2023,202301190LAK,Dallas Stars,DAL,0,LAK,4,6,10,24,29,21,0,0,0,32,26,13
2022-23,1/19/2023,202301190MTL,Florida Panthers,FLA,0,MTL,6,11,17,39,14,19,2,4,6,25,25,14
2022-23,1/19/2023,202301190NYR,Boston Bruins,BOS,0,NYR,2,3,5,23,20,23,0,2,2,30,19,8
2022-23,1/19/2023,202301190PHI,Chicago Blackhawks,CHI,0,PHI,3,6,9,28,24,22,1,2,3,38,17,15
2022-23,1/19/2023,202301190SEA,New Jersey Devils,NJD,0,SEA,3,5,8,30,18,19,4,6,10,40,21,15
2022-23,1/19/2023,202301190STL,Nashville Predators,NSH,0,STL,2,3,5,26,30,10,5,10,15,33,18,10
2022-23,1/19/2023,202301190TOR,Toronto Maple Leafs,TOR,1,WPG,4,6,10,27,21,15,1,2,3,38,23,4
2022-23,1/19/2023,202301190VEG,Detroit Red Wings,DET,0,VEG,3,5,8,25,31,15,2,4,6,34,27,12
2022-23,1/19/2023,202301190ARI,Washington Capitals,WSH,0,ARI,4,8,12,33,21,8,0,0,0,25,16,16
2022-23,1/19/2023,202301190BUF,New York Islanders,NYI,0,BUF,2,2,4,26,23,27,3,6,9,45,9,10
2022-23,1/19/2023,202301190CAR,Minnesota Wild,MIN,0,CAR,2,4,6,31,14,18,5,8,13,28,9,15
2022-23,1/19/2023,202301190CBJ,Columbus Blue Jackets,CBJ,1,ANA,3,4,7,32,15,11,5,10,15,33,15,12
2022-23,1/19/2023,202301190EDM,Tampa Bay Lightning,TBL,0,EDM,3,6,9,31,27,19,5,8,13,34,23,10
2022-23,1/19/2023,202301190LAK,Los Angeles Kings,LAK,1,DAL,0,0,0,32,26,13,4,6,10,24,29,21
2022-23,1/19/2023,202301190MTL,Montreal Canadiens,MTL,1,FLA,2,4,6,25,25,14,6,11,17,39,14,19
2022-23,1/19/2023,202301190NYR,New York Rangers,NYR,1,BOS,0,2,2,30,19,8,2,3,5,23,20,23
2022-23,1/19/2023,202301190PHI,Philadelphia Flyers,PHI,1,CHI,1,2,3,38,17,15,3,6,9,28,24,22
2022-23,1/19/2023,202301190SEA,Seattle Kraken,SEA,1,NJD,4,6,10,40,21,15,3,5,8,30,18,19
2022-23,1/19/2023,202301190STL,St. Louis Blues,STL,1,NSH,5,10,15,33,18,10,2,3,5,26,30,10
2022-23,1/19/2023,202301190TOR,Winnipeg Jets,WPG,0,TOR,1,2,3,38,23,4,4,6,10,27,21,15
2022-23,1/19/2023,202301190VEG,Vegas Golden Knights,VEG,1,DET,2,4,6,34,27,12,3,5,8,25,31,15
2022-23,1/18/2023,202301180CGY,Calgary Flames,CGY,1,COL,1,2,3,33,17,6,4,7,11,29,12,13
2022-23,1/18/2023,202301180NYI,Boston Bruins,BOS,0,NYI,4,7,11,22,22,20,1,2,3,25,20,10
2022-23,1/18/2023,202301180OTT,Ottawa Senators,OTT,1,PIT,5,9,14,38,21,8,4,8,12,19,34,9
2022-23,1/18/2023,202301180SJS,Dallas Stars,DAL,0,SJS,3,6,9,36,18,10,5,8,13,28,21,9
2022-23,1/18/2023,202301180VAN,Tampa Bay Lightning,TBL,0,VAN,5,7,12,25,11,21,2,4,6,38,18,5
2022-23,1/18/2023,202301180CGY,Colorado Avalanche,COL,0,CGY,4,7,11,29,12,13,1,2,3,33,17,6
2022-23,1/18/2023,202301180NYI,New York Islanders,NYI,1,BOS,1,2,3,25,20,10,4,7,11,22,22,20
2022-23,1/18/2023,202301180OTT,Pittsburgh Penguins,PIT,0,OTT,4,8,12,19,34,9,5,9,14,38,21,8
2022-23,1/18/2023,202301180SJS,San Jose Sharks,SJS,1,DAL,5,8,13,28,21,9,3,6,9,36,18,10
2022-23,1/18/2023,202301180VAN,Vancouver Canucks,VAN,1,TBL,2,4,6,38,18,5,5,7,12,25,11,21
2022-23,1/17/2023,202301170ARI,Arizona Coyotes,ARI,1,DET,3,6,9,22,21,14,3,5,8,40,27,21
2022-23,1/17/2023,202301170CHI,Buffalo Sabres,BUF,0,CHI,3,4,7,33,13,15,4,6,10,26,28,12
2022-23,1/17/2023,202301170EDM,Edmonton Oilers,EDM,1,SEA,5,7,12,33,36,14,2,3,5,31,43,13
2022-23,1/17/2023,202301170MTL,Montreal Canadiens,MTL,1,WPG,4,8,12,28,25,18,1,2,3,22,15,10
2022-23,1/17/2023,202301170NSH,Columbus Blue Jackets,CBJ,0,NSH,1,2,3,40,28,11,2,4,6,28,20,13
2022-23,1/17/2023,202301170PHI,Anaheim Ducks,ANA,0,PHI,2,4,6,27,17,12,5,8,13,37,22,10
2022-23,1/17/2023,202301170TOR,Florida Panthers,FLA,0,TOR,4,6,10,18,28,14,5,10,15,37,14,13
2022-23,1/17/2023,202301170WSH,Minnesota Wild,MIN,0,WSH,4,5,9,22,33,15,2,4,6,35,29,17
2022-23,1/17/2023,202301170ARI,Detroit Red Wings,DET,0,ARI,3,5,8,40,27,21,3,6,9,22,21,14
2022-23,1/17/2023,202301170CHI,Chicago Blackhawks,CHI,1,BUF,4,6,10,26,28,12,3,4,7,33,13,15
2022-23,1/17/2023,202301170EDM,Seattle Kraken,SEA,0,EDM,2,3,5,31,43,13,5,7,12,33,36,14
2022-23,1/17/2023,202301170MTL,Winnipeg Jets,WPG,0,MTL,1,2,3,22,15,10,4,8,12,28,25,18
2022-23,1/17/2023,202301170NSH,Nashville Predators,NSH,1,CBJ,2,4,6,28,20,13,1,2,3,40,28,11
2022-23,1/17/2023,202301170PHI,Philadelphia Flyers,PHI,1,ANA,5,8,13,37,22,10,2,4,6,27,17,12
2022-23,1/17/2023,202301170TOR,Toronto Maple Leafs,TOR,1,FLA,5,10,15,37,14,13,4,6,10,18,28,14
2022-23,1/17/2023,202301170WSH,Washington Capitals,WSH,1,MIN,2,4,6,35,29,17,4,5,9,22,33,15
2022-23,1/16/2023,202301160BOS,Boston Bruins,BOS,1,PHI,6,7,13,24,10,15,0,0,0,26,19,15
2022-23,1/16/2023,202301160BUF,Buffalo Sabres,BUF,1,FLA,1,0,1,26,13,14,4,7,11,34,27,16
2022-23,1/16/2023,202301160CBJ,Columbus Blue Jackets,CBJ,1,NYR,1,2,3,24,20,21,2,6,8,27,12,13
2022-23,1/16/2023,202301160COL,Colorado Avalanche,COL,1,DET,6,10,16,26,20,10,3,6,9,29,23,24
2022-23,1/16/2023,202301160NSH,Calgary Flames,CGY,0,NSH,1,2,3,38,27,17,2,4,6,29,30,14
2022-23,1/16/2023,202301160NYI,New York Islanders,NYI,1,WSH,3,5,8,30,38,16,4,8,12,32,37,13
2022-23,1/16/2023,202301160PIT,Anaheim Ducks,ANA,0,PIT,3,5,8,29,25,21,4,7,11,45,32,13
2022-23,1/16/2023,202301160SEA,Seattle Kraken,SEA,1,TBL,1,1,2,23,16,14,4,6,10,31,18,13
2022-23,1/16/2023,202301160SJS,New Jersey Devils,NJD,0,SJS,3,6,9,41,24,13,3,6,9,32,28,19
2022-23,1/16/2023,202301160STL,Ottawa Senators,OTT,0,STL,1,2,3,31,22,17,2,1,3,20,21,9
2022-23,1/16/2023,202301160VEG,Dallas Stars,DAL,0,VEG,4,6,10,36,33,15,0,0,0,25,39,17
2022-23,1/16/2023,202301160BOS,Philadelphia Flyers,PHI,0,BOS,0,0,0,26,19,15,6,7,13,24,10,15
2022-23,1/16/2023,202301160BUF,Florida Panthers,FLA,0,BUF,4,7,11,34,27,16,1,0,1,26,13,14
2022-23,1/16/2023,202301160CBJ,New York Rangers,NYR,0,CBJ,2,6,8,27,12,13,1,2,3,24,20,21
2022-23,1/16/2023,202301160COL,Detroit Red Wings,DET,0,COL,3,6,9,29,23,24,6,10,16,26,20,10
2022-23,1/16/2023,202301160NSH,Nashville Predators,NSH,1,CGY,2,4,6,29,30,14,1,2,3,38,27,17
2022-23,1/16/2023,202301160NYI,Washington Capitals,WSH,0,NYI,4,8,12,32,37,13,3,5,8,30,38,16
2022-23,1/16/2023,202301160PIT,Pittsburgh Penguins,PIT,1,ANA,4,7,11,45,32,13,3,5,8,29,25,21
2022-23,1/16/2023,202301160SEA,Tampa Bay Lightning,TBL,0,SEA,4,6,10,31,18,13,1,1,2,23,16,14
2022-23,1/16/2023,202301160SJS,San Jose Sharks,SJS,1,NJD,3,6,9,32,28,19,3,6,9,41,24,13
2022-23,1/16/2023,202301160STL,St. Louis Blues,STL,1,OTT,2,1,3,20,21,9,1,2,3,31,22,17
2022-23,1/16/2023,202301160VEG,Vegas Golden Knights,VEG,1,DAL,0,0,0,25,39,17,4,6,10,36,33,15
2022-23,1/15/2023,202301150CAR,Carolina Hurricanes,CAR,1,VAN,2,5,7,31,16,11,3,5,8,32,30,17
2022-23,1/15/2023,202301150NYR,Montreal Canadiens,MTL,0,NYR,2,4,6,31,14,24,1,2,3,36,21,6
2022-23,1/15/2023,202301150WPG,Arizona Coyotes,ARI,0,WPG,1,2,3,20,14,8,2,4,6,21,13,9
2022-23,1/15/2023,202301150CAR,Vancouver Canucks,VAN,0,CAR,3,5,8,32,30,17,2,5,7,31,16,11
2022-23,1/15/2023,202301150NYR,New York Rangers,NYR,1,MTL,1,2,3,36,21,6,2,4,6,31,14,24
2022-23,1/15/2023,202301150WPG,Winnipeg Jets,WPG,1,ARI,2,4,6,21,13,9,1,2,3,20,14,8
2022-23,1/14/2023,202301140BOS,Boston Bruins,BOS,1,TOR,3,5,8,30,24,18,3,4,7,20,33,16
2022-23,1/14/2023,202301140CAR,Carolina Hurricanes,CAR,1,PIT,2,3,5,35,24,15,1,0,1,35,33,9
2022-23,1/14/2023,202301140CHI,Chicago Blackhawks,CHI,1,SEA,4,7,11,26,26,10,8,14,22,30,17,5
2022-23,1/14/2023,202301140COL,Colorado Avalanche,COL,1,OTT,6,12,18,32,17,15,0,0,0,27,15,12
2022-23,1/14/2023,202301140DAL,Calgary Flames,CGY,0,DAL,6,10,16,36,20,11,5,9,14,33,29,17
2022-23,1/14/2023,202301140DET,Columbus Blue Jackets,CBJ,0,DET,4,8,12,24,25,16,3,4,7,28,23,8
2022-23,1/14/2023,202301140FLA,Florida Panthers,FLA,1,VAN,3,8,11,34,17,11,3,5,8,37,15,9
2022-23,1/14/2023,202301140LAK,Los Angeles Kings,LAK,1,NJD,2,4,6,35,20,19,5,8,13,28,32,13
2022-23,1/14/2023,202301140MIN,Arizona Coyotes,ARI,0,MIN,1,2,3,26,16,6,2,4,6,27,25,16
2022-23,1/14/2023,202301140NSH,Buffalo Sabres,BUF,0,NSH,5,8,13,33,14,17,3,6,9,40,36,10
2022-23,1/14/2023,202301140NYI,Montreal Canadiens,MTL,0,NYI,1,1,2,23,17,25,2,4,6,33,25,14
2022-23,1/14/2023,202301140STL,St. Louis Blues,STL,1,TBL,2,3,5,25,19,19,4,6,10,30,15,12
2022-23,1/14/2023,202301140VEG,Edmonton Oilers,EDM,0,VEG,4,6,10,37,30,13,3,5,8,26,36,12
2022-23,1/14/2023,202301140WSH,Philadelphia Flyers,PHI,0,WSH,2,6,8,24,25,22,1,0,1,39,29,12
2022-23,1/14/2023,202301140BOS,Toronto Maple Leafs,TOR,0,BOS,3,4,7,20,33,16,3,5,8,30,24,18
2022-23,1/14/2023,202301140CAR,Pittsburgh Penguins,PIT,0,CAR,1,0,1,35,33,9,2,3,5,35,24,15
2022-23,1/14/2023,202301140CHI,Seattle Kraken,SEA,0,CHI,8,14,22,30,17,5,4,7,11,26,26,10
2022-23,1/14/2023,202301140COL,Ottawa Senators,OTT,0,COL,0,0,0,27,15,12,6,12,18,32,17,15
2022-23,1/14/2023,202301140DAL,Dallas Stars,DAL,1,CGY,5,9,14,33,29,17,6,10,16,36,20,11
2022-23,1/14/2023,202301140DET,Detroit Red Wings,DET,1,CBJ,3,4,7,28,23,8,4,8,12,24,25,16
2022-23,1/14/2023,202301140FLA,Vancouver Canucks,VAN,0,FLA,3,5,8,37,15,9,3,8,11,34,17,11
2022-23,1/14/2023,202301140LAK,New Jersey Devils,NJD,0,LAK,5,8,13,28,32,13,2,4,6,35,20,19
2022-23,1/14/2023,202301140MIN,Minnesota Wild,MIN,1,ARI,2,4,6,27,25,16,1,2,3,26,16,6
2022-23,1/14/2023,202301140NSH,Nashville Predators,NSH,1,BUF,3,6,9,40,36,10,5,8,13,33,14,17
2022-23,1/14/2023,202301140NYI,New York Islanders,NYI,1,MTL,2,4,6,33,25,14,1,1,2,23,17,25
2022-23,1/14/2023,202301140STL,Tampa Bay Lightning,TBL,0,STL,4,6,10,30,15,12,2,3,5,25,19,19
2022-23,1/14/2023,202301140VEG,Vegas Golden Knights,VEG,1,EDM,3,5,8,26,36,12,4,6,10,37,30,13
2022-23,1/14/2023,202301140WSH,Washington Capitals,WSH,1,PHI,1,0,1,39,29,12,2,6,8,24,25,22
2022-23,1/13/2023,202301130ANA,Anaheim Ducks,ANA,1,NJD,2,3,5,33,21,7,6,10,16,39,22,13
2022-23,1/13/2023,202301130PIT,Pittsburgh Penguins,PIT,1,WPG,1,2,3,23,38,15,4,7,11,37,31,9
2022-23,1/13/2023,202301130SJS,Edmonton Oilers,EDM,0,SJS,7,11,18,41,11,13,1,2,3,26,27,11
2022-23,1/13/2023,202301130ANA,New Jersey Devils,NJD,0,ANA,6,10,16,39,22,13,2,3,5,33,21,7
2022-23,1/13/2023,202301130PIT,Winnipeg Jets,WPG,0,PIT,4,7,11,37,31,9,1,2,3,23,38,15
2022-23,1/13/2023,202301130SJS,San Jose Sharks,SJS,1,EDM,1,2,3,26,27,11,7,11,18,41,11,13
2022-23,1/12/2023,202301120ARI,Arizona Coyotes,ARI,1,OTT,3,5,8,25,31,13,4,5,9,40,33,19
2022-23,1/12/2023,202301120BOS,Boston Bruins,BOS,1,SEA,0,0,0,20,29,10,3,5,8,31,26,19
2022-23,1/12/2023,202301120BUF,Buffalo Sabres,BUF,1,WPG,2,4,6,40,9,9,3,6,9,25,18,22
2022-23,1/12/2023,202301120CBJ,Carolina Hurricanes,CAR,0,CBJ,6,9,15,40,11,8,2,3,5,22,15,17
2022-23,1/12/2023,202301120CHI,Chicago Blackhawks,CHI,1,COL,3,3,6,28,31,17,2,3,5,32,16,9
2022-23,1/12/2023,202301120DET,Detroit Red Wings,DET,1,TOR,4,7,11,23,15,11,1,2,3,32,13,8
2022-23,1/12/2023,202301120MTL,Montreal Canadiens,MTL,1,NSH,4,8,12,35,23,26,3,5,8,42,29,17
2022-23,1/12/2023,202301120NYI,Minnesota Wild,MIN,0,NYI,3,5,8,36,19,18,1,2,3,19,19,16
2022-23,1/12/2023,202301120NYR,Dallas Stars,DAL,0,NYR,1,2,3,25,16,22,2,4,6,31,13,16
2022-23,1/12/2023,202301120STL,Calgary Flames,CGY,0,STL,4,6,10,40,26,6,1,2,3,23,22,10
2022-23,1/12/2023,202301120TBL,Tampa Bay Lightning,TBL,1,VAN,5,10,15,35,25,13,4,7,11,39,29,14
2022-23,1/12/2023,202301120VEG,Florida Panthers,FLA,0,VEG,2,4,6,38,33,11,4,3,7,32,35,24
2022-23,1/12/2023,202301120ARI,Ottawa Senators,OTT,0,ARI,4,5,9,40,33,19,3,5,8,25,31,13
2022-23,1/12/2023,202301120BOS,Seattle Kraken,SEA,0,BOS,3,5,8,31,26,19,0,0,0,20,29,10
2022-23,1/12/2023,202301120BUF,Winnipeg Jets,WPG,0,BUF,3,6,9,25,18,22,2,4,6,40,9,9
2022-23,1/12/2023,202301120CBJ,Columbus Blue Jackets,CBJ,1,CAR,2,3,5,22,15,17,6,9,15,40,11,8
2022-23,1/12/2023,202301120CHI,Colorado Avalanche,COL,0,CHI,2,3,5,32,16,9,3,3,6,28,31,17
2022-23,1/12/2023,202301120DET,Toronto Maple Leafs,TOR,0,DET,1,2,3,32,13,8,4,7,11,23,15,11
2022-23,1/12/2023,202301120MTL,Nashville Predators,NSH,0,MTL,3,5,8,42,29,17,4,8,12,35,23,26
2022-23,1/12/2023,202301120NYI,New York Islanders,NYI,1,MIN,1,2,3,19,19,16,3,5,8,36,19,18
2022-23,1/12/2023,202301120NYR,New York Rangers,NYR,1,DAL,2,4,6,31,13,16,1,2,3,25,16,22
2022-23,1/12/2023,202301120STL,St. Louis Blues,STL,1,CGY,1,2,3,23,22,10,4,6,10,40,26,6
2022-23,1/12/2023,202301120TBL,Vancouver Canucks,VAN,0,TBL,4,7,11,39,29,14,5,10,15,35,25,13
2022-23,1/12/2023,202301120VEG,Vegas Golden Knights,VEG,1,FLA,4,3,7,32,35,24,2,4,6,38,33,11
2022-23,1/11/2023,202301110ANA,Anaheim Ducks,ANA,1,EDM,2,3,5,23,23,16,6,8,14,53,15,8
2022-23,1/11/2023,202301110LAK,Los Angeles Kings,LAK,1,SJS,4,7,11,35,27,22,3,4,7,30,33,13
2022-23,1/11/2023,202301110PHI,Philadelphia Flyers,PHI,1,WSH,5,7,12,36,27,16,3,4,7,29,28,7
2022-23,1/11/2023,202301110TOR,Nashville Predators,NSH,0,TOR,1,2,3,33,36,13,2,4,6,35,25,14
2022-23,1/11/2023,202301110ANA,Edmonton Oilers,EDM,0,ANA,6,8,14,53,15,8,2,3,5,23,23,16
2022-23,1/11/2023,202301110LAK,San Jose Sharks,SJS,0,LAK,3,4,7,30,33,13,4,7,11,35,27,22
2022-23,1/11/2023,202301110PHI,Washington Capitals,WSH,0,PHI,3,4,7,29,28,7,5,7,12,36,27,16
2022-23,1/11/2023,202301110TOR,Toronto Maple Leafs,TOR,1,NSH,2,4,6,35,25,14,1,2,3,33,36,13
2022-23,1/10/2023,202301100ARI,Arizona Coyotes,ARI,1,SJS,2,4,6,27,27,15,4,8,12,32,22,17
2022-23,1/10/2023,202301100BUF,Buffalo Sabres,BUF,1,SEA,3,6,9,34,16,4,4,7,11,22,21,13
2022-23,1/10/2023,202301100CAR,Carolina Hurricanes,CAR,1,NJD,3,5,8,28,22,10,5,10,15,22,25,28
2022-23,1/10/2023,202301100COL,Colorado Avalanche,COL,1,FLA,4,7,11,29,19,12,5,6,11,36,28,14
2022-23,1/10/2023,202301100DET,Detroit Red Wings,DET,1,WPG,7,12,19,23,23,23,5,10,15,36,19,11
2022-23,1/10/2023,202301100NYI,Dallas Stars,DAL,0,NYI,1,2,3,26,15,22,1,2,3,27,26,17
2022-23,1/10/2023,202301100NYR,Minnesota Wild,MIN,0,NYR,3,6,9,32,26,29,3,3,6,41,17,5
2022-23,1/10/2023,202301100PIT,Pittsburgh Penguins,PIT,1,VAN,5,8,13,36,25,9,4,8,12,24,19,17
2022-23,1/10/2023,202301100STL,Calgary Flames,CGY,0,STL,3,6,9,28,25,4,4,6,10,26,22,10
2022-23,1/10/2023,202301100TBL,Columbus Blue Jackets,CBJ,0,TBL,1,4,5,18,33,10,6,11,17,46,25,16
2022-23,1/10/2023,202301100ARI,San Jose Sharks,SJS,0,ARI,4,8,12,32,22,17,2,4,6,27,27,15
2022-23,1/10/2023,202301100BUF,Seattle Kraken,SEA,0,BUF,4,7,11,22,21,13,3,6,9,34,16,4
2022-23,1/10/2023,202301100CAR,New Jersey Devils,NJD,0,CAR,5,10,15,22,25,28,3,5,8,28,22,10
2022-23,1/10/2023,202301100COL,Florida Panthers,FLA,0,COL,5,6,11,36,28,14,4,7,11,29,19,12
2022-23,1/10/2023,202301100DET,Winnipeg Jets,WPG,0,DET,5,10,15,36,19,11,7,12,19,23,23,23
2022-23,1/10/2023,202301100NYI,New York Islanders,NYI,1,DAL,1,2,3,27,26,17,1,2,3,26,15,22
2022-23,1/10/2023,202301100NYR,New York Rangers,NYR,1,MIN,3,3,6,41,17,5,3,6,9,32,26,29
2022-23,1/10/2023,202301100PIT,Vancouver Canucks,VAN,0,PIT,4,8,12,24,19,17,5,8,13,36,25,9
2022-23,1/10/2023,202301100STL,St. Louis Blues,STL,1,CGY,4,6,10,26,22,10,3,6,9,28,25,4
2022-23,1/10/2023,202301100TBL,Tampa Bay Lightning,TBL,1,CBJ,6,11,17,46,25,16,1,4,5,18,33,10
2022-23,1/9/2023,202301090BUF,Buffalo Sabres,BUF,1,PHI,0,0,0,28,8,14,3,7,10,35,14,8
2022-23,1/9/2023,202301090LAK,Edmonton Oilers,EDM,0,LAK,3,4,7,31,22,9,6,9,15,38,26,20
2022-23,1/9/2023,202301090MTL,Montreal Canadiens,MTL,1,SEA,0,0,0,21,24,17,4,7,11,41,15,20
2022-23,1/9/2023,202301090OTT,Nashville Predators,NSH,0,OTT,3,6,9,36,23,22,0,0,0,34,20,6
2022-23,1/9/2023,202301090BUF,Philadelphia Flyers,PHI,0,BUF,3,7,10,35,14,8,0,0,0,28,8,14
2022-23,1/9/2023,202301090LAK,Los Angeles Kings,LAK,1,EDM,6,9,15,38,26,20,3,4,7,31,22,9
2022-23,1/9/2023,202301090MTL,Seattle Kraken,SEA,0,MTL,4,7,11,41,15,20,0,0,0,21,24,17
2022-23,1/9/2023,202301090OTT,Ottawa Senators,OTT,1,NSH,0,0,0,34,20,6,3,6,9,36,23,22
2022-23,1/8/2023,202301080ANA,Anaheim Ducks,ANA,1,BOS,1,2,3,29,20,9,6,8,14,35,18,20
2022-23,1/8/2023,202301080ARI,Arizona Coyotes,ARI,1,PIT,1,2,3,22,22,14,4,6,10,28,20,13
2022-23,1/8/2023,202301080CHI,Calgary Flames,CGY,0,CHI,3,5,8,44,20,12,4,7,11,23,22,23
2022-23,1/8/2023,202301080DAL,Dallas Stars,DAL,1,FLA,5,7,12,34,18,17,1,2,3,28,20,9
2022-23,1/8/2023,202301080MIN,Minnesota Wild,MIN,1,STL,0,0,0,35,23,9,3,5,8,24,16,21
2022-23,1/8/2023,202301080PHI,Philadelphia Flyers,PHI,1,TOR,2,1,3,33,35,12,6,9,15,35,14,15
2022-23,1/8/2023,202301080WPG,Vancouver Canucks,VAN,0,WPG,3,8,11,36,29,12,7,14,21,27,22,8
2022-23,1/8/2023,202301080WSH,Columbus Blue Jackets,CBJ,0,WSH,0,0,0,33,24,12,1,2,3,19,29,26
2022-23,1/8/2023,202301080ANA,Boston Bruins,BOS,0,ANA,6,8,14,35,18,20,1,2,3,29,20,9
2022-23,1/8/2023,202301080ARI,Pittsburgh Penguins,PIT,0,ARI,4,6,10,28,20,13,1,2,3,22,22,14
2022-23,1/8/2023,202301080CHI,Chicago Blackhawks,CHI,1,CGY,4,7,11,23,22,23,3,5,8,44,20,12
2022-23,1/8/2023,202301080DAL,Florida Panthers,FLA,0,DAL,1,2,3,28,20,9,5,7,12,34,18,17
2022-23,1/8/2023,202301080MIN,St. Louis Blues,STL,0,MIN,3,5,8,24,16,21,0,0,0,35,23,9
2022-23,1/8/2023,202301080PHI,Toronto Maple Leafs,TOR,0,PHI,6,9,15,35,14,15,2,1,3,33,35,12
2022-23,1/8/2023,202301080WPG,Winnipeg Jets,WPG,1,VAN,7,14,21,27,22,8,3,8,11,36,29,12
2022-23,1/8/2023,202301080WSH,Washington Capitals,WSH,1,CBJ,1,2,3,19,29,26,0,0,0,33,24,12
2022-23,1/7/2023,202301070BUF,Buffalo Sabres,BUF,1,MIN,6,11,17,37,7,4,5,8,13,44,21,16
2022-23,1/7/2023,202301070CBJ,Carolina Hurricanes,CAR,0,CBJ,3,4,7,38,11,5,3,4,7,18,18,11
2022-23,1/7/2023,202301070EDM,Colorado Avalanche,COL,0,EDM,2,5,7,42,18,13,2,4,6,30,22,16
2022-23,1/7/2023,202301070MTL,Montreal Canadiens,MTL,1,STL,5,9,14,27,21,12,4,6,10,18,10,9
2022-23,1/7/2023,202301070NJD,New Jersey Devils,NJD,1,NYR,4,4,8,43,21,13,3,6,9,33,17,25
2022-23,1/7/2023,202301070OTT,Ottawa Senators,OTT,1,SEA,4,5,9,19,41,11,8,13,21,24,32,19
2022-23,1/7/2023,202301070SJS,Boston Bruins,BOS,0,SJS,4,6,10,26,15,18,2,4,6,29,23,15
2022-23,1/7/2023,202301070TOR,Detroit Red Wings,DET,0,TOR,1,2,3,23,36,13,4,8,12,29,21,9
2022-23,1/7/2023,202301070VEG,Los Angeles Kings,LAK,0,VEG,5,10,15,23,22,12,1,1,2,20,44,9
2022-23,1/7/2023,202301070BUF,Minnesota Wild,MIN,0,BUF,5,8,13,44,21,16,6,11,17,37,7,4
2022-23,1/7/2023,202301070CBJ,Columbus Blue Jackets,CBJ,1,CAR,3,4,7,18,18,11,3,4,7,38,11,5
2022-23,1/7/2023,202301070EDM,Edmonton Oilers,EDM,1,COL,2,4,6,30,22,16,2,5,7,42,18,13
2022-23,1/7/2023,202301070MTL,St. Louis Blues,STL,0,MTL,4,6,10,18,10,9,5,9,14,27,21,12
2022-23,1/7/2023,202301070NJD,New York Rangers,NYR,0,NJD,3,6,9,33,17,25,4,4,8,43,21,13
2022-23,1/7/2023,202301070OTT,Seattle Kraken,SEA,0,OTT,8,13,21,24,32,19,4,5,9,19,41,11
2022-23,1/7/2023,202301070SJS,San Jose Sharks,SJS,1,BOS,2,4,6,29,23,15,4,6,10,26,15,18
2022-23,1/7/2023,202301070TOR,Toronto Maple Leafs,TOR,1,DET,4,8,12,29,21,9,1,2,3,23,36,13
2022-23,1/7/2023,202301070VEG,Vegas Golden Knights,VEG,1,LAK,1,1,2,20,44,9,5,10,15,23,22,12
2022-23,1/6/2023,202301060ANA,Anaheim Ducks,ANA,1,SJS,5,8,13,26,17,9,4,8,12,34,14,15
2022-23,1/6/2023,202301060CGY,Calgary Flames,CGY,1,NYI,4,6,10,20,17,8,1,2,3,22,31,19
2022-23,1/6/2023,202301060CHI,Arizona Coyotes,ARI,0,CHI,0,0,0,21,14,12,2,3,5,31,21,12
2022-23,1/6/2023,202301060DET,Detroit Red Wings,DET,1,FLA,2,4,6,31,20,7,3,5,8,19,20,15
2022-23,1/6/2023,202301060WPG,Tampa Bay Lightning,TBL,0,WPG,2,3,5,28,11,14,4,7,11,19,29,17
2022-23,1/6/2023,202301060WSH,Nashville Predators,NSH,0,WSH,3,5,8,21,28,21,2,4,6,31,29,17
2022-23,1/6/2023,202301060ANA,San Jose Sharks,SJS,0,ANA,4,8,12,34,14,15,5,8,13,26,17,9
2022-23,1/6/2023,202301060CGY,New York Islanders,NYI,0,CGY,1,2,3,22,31,19,4,6,10,20,17,8
2022-23,1/6/2023,202301060CHI,Chicago Blackhawks,CHI,1,ARI,2,3,5,31,21,12,0,0,0,21,14,12
2022-23,1/6/2023,202301060DET,Florida Panthers,FLA,0,DET,3,5,8,19,20,15,2,4,6,31,20,7
2022-23,1/6/2023,202301060WPG,Winnipeg Jets,WPG,1,TBL,4,7,11,19,29,17,2,3,5,28,11,14
2022-23,1/6/2023,202301060WSH,Washington Capitals,WSH,1,NSH,2,4,6,31,29,17,3,5,8,21,28,21
2022-23,1/5/2023,202301050CAR,Carolina Hurricanes,CAR,1,NSH,2,6,8,60,17,14,5,7,12,24,18,21
2022-23,1/5/2023,202301050CBJ,Columbus Blue Jackets,CBJ,1,WSH,1,3,4,24,12,14,6,10,16,37,16,12
2022-23,1/5/2023,202301050EDM,Edmonton Oilers,EDM,1,NYI,4,7,11,38,23,13,2,2,4,19,42,19
2022-23,1/5/2023,202301050LAK,Boston Bruins,BOS,0,LAK,5,6,11,18,27,18,2,4,6,29,22,15
2022-23,1/5/2023,202301050MTL,Montreal Canadiens,MTL,1,NYR,1,2,3,18,21,16,4,5,9,28,17,15
2022-23,1/5/2023,202301050NJD,New Jersey Devils,NJD,1,STL,3,5,8,39,8,9,5,9,14,18,21,21
2022-23,1/5/2023,202301050PHI,Arizona Coyotes,ARI,0,PHI,1,3,4,19,20,12,5,12,17,30,18,15
2022-23,1/5/2023,202301050TOR,Seattle Kraken,SEA,0,TOR,5,8,13,26,32,12,1,2,3,27,27,13
2022-23,1/5/2023,202301050VAN,Colorado Avalanche,COL,0,VAN,2,4,6,30,21,6,4,8,12,42,29,21
2022-23,1/5/2023,202301050VEG,Pittsburgh Penguins,PIT,0,VEG,2,4,6,40,34,12,4,9,13,28,24,23
2022-23,1/5/2023,202301050CAR,Nashville Predators,NSH,0,CAR,5,7,12,24,18,21,2,6,8,60,17,14
2022-23,1/5/2023,202301050CBJ,Washington Capitals,WSH,0,CBJ,6,10,16,37,16,12,1,3,4,24,12,14
2022-23,1/5/2023,202301050EDM,New York Islanders,NYI,0,EDM,2,2,4,19,42,19,4,7,11,38,23,13
2022-23,1/5/2023,202301050LAK,Los Angeles Kings,LAK,1,BOS,2,4,6,29,22,15,5,6,11,18,27,18
2022-23,1/5/2023,202301050MTL,New York Rangers,NYR,0,MTL,4,5,9,28,17,15,1,2,3,18,21,16
2022-23,1/5/2023,202301050NJD,St. Louis Blues,STL,0,NJD,5,9,14,18,21,21,3,5,8,39,8,9
2022-23,1/5/2023,202301050PHI,Philadelphia Flyers,PHI,1,ARI,5,12,17,30,18,15,1,3,4,19,20,12
2022-23,1/5/2023,202301050TOR,Toronto Maple Leafs,TOR,1,SEA,1,2,3,27,27,13,5,8,13,26,32,12
2022-23,1/5/2023,202301050VAN,Vancouver Canucks,VAN,1,COL,4,8,12,42,29,21,2,4,6,30,21,6
2022-23,1/5/2023,202301050VEG,Vegas Golden Knights,VEG,1,PIT,4,9,13,28,24,23,2,4,6,40,34,12
2022-23,1/4/2023,202301040ANA,Anaheim Ducks,ANA,1,DAL,2,4,6,27,23,27,0,0,0,35,23,15
2022-23,1/4/2023,202301040DET,Detroit Red Wings,DET,1,NJD,1,2,3,32,17,13,5,10,15,27,17,13
2022-23,1/4/2023,202301040MIN,Minnesota Wild,MIN,1,TBL,5,7,12,33,21,15,1,2,3,35,18,12
2022-23,1/4/2023,202301040ANA,Dallas Stars,DAL,0,ANA,0,0,0,35,23,15,2,4,6,27,23,27
2022-23,1/4/2023,202301040DET,New Jersey Devils,NJD,0,DET,5,10,15,27,17,13,1,2,3,32,17,13
2022-23,1/4/2023,202301040MIN,Tampa Bay Lightning,TBL,0,MIN,1,2,3,35,18,12,5,7,12,33,21,15
2022-23,1/3/2023,202301030CHI,Chicago Blackhawks,CHI,1,TBL,1,2,3,26,18,14,4,6,10,29,11,20
2022-23,1/3/2023,202301030EDM,Edmonton Oilers,EDM,1,SEA,2,4,6,32,31,9,5,10,15,24,38,18
2022-23,1/3/2023,202301030FLA,Arizona Coyotes,ARI,0,FLA,3,5,8,32,17,6,3,6,9,35,29,12
2022-23,1/3/2023,202301030LAK,Dallas Stars,DAL,0,LAK,2,3,5,30,39,15,3,5,8,34,26,16
2022-23,1/3/2023,202301030NSH,Montreal Canadiens,MTL,0,NSH,3,4,7,27,17,15,6,11,17,33,27,11
2022-23,1/3/2023,202301030NYR,Carolina Hurricanes,CAR,0,NYR,3,3,6,22,14,11,5,7,12,28,14,11
2022-23,1/3/2023,202301030OTT,Columbus Blue Jackets,CBJ,0,OTT,0,0,0,18,26,11,3,6,9,32,20,17
2022-23,1/3/2023,202301030TOR,St. Louis Blues,STL,0,TOR,4,9,13,27,49,17,5,9,14,25,19,16
2022-23,1/3/2023,202301030VAN,New York Islanders,NYI,0,VAN,5,9,14,25,29,18,2,4,6,23,19,3
2022-23,1/3/2023,202301030WPG,Calgary Flames,CGY,0,WPG,2,3,5,34,16,17,3,5,8,22,14,13
2022-23,1/3/2023,202301030WSH,Buffalo Sabres,BUF,0,WSH,5,9,14,29,21,10,4,5,9,32,32,12
2022-23,1/3/2023,202301030CHI,Tampa Bay Lightning,TBL,0,CHI,4,6,10,29,11,20,1,2,3,26,18,14
2022-23,1/3/2023,202301030EDM,Seattle Kraken,SEA,0,EDM,5,10,15,24,38,18,2,4,6,32,31,9
2022-23,1/3/2023,202301030FLA,Florida Panthers,FLA,1,ARI,3,6,9,35,29,12,3,5,8,32,17,6
2022-23,1/3/2023,202301030LAK,Los Angeles Kings,LAK,1,DAL,3,5,8,34,26,16,2,3,5,30,39,15
2022-23,1/3/2023,202301030NSH,Nashville Predators,NSH,1,MTL,6,11,17,33,27,11,3,4,7,27,17,15
2022-23,1/3/2023,202301030NYR,New York Rangers,NYR,1,CAR,5,7,12,28,14,11,3,3,6,22,14,11
2022-23,1/3/2023,202301030OTT,Ottawa Senators,OTT,1,CBJ,3,6,9,32,20,17,0,0,0,18,26,11
2022-23,1/3/2023,202301030TOR,Toronto Maple Leafs,TOR,1,STL,5,9,14,25,19,16,4,9,13,27,49,17
2022-23,1/3/2023,202301030VAN,Vancouver Canucks,VAN,1,NYI,2,4,6,23,19,3,5,9,14,25,29,18
2022-23,1/3/2023,202301030WPG,Winnipeg Jets,WPG,1,CGY,3,5,8,22,14,13,2,3,5,34,16,17
2022-23,1/3/2023,202301030WSH,Washington Capitals,WSH,1,BUF,4,5,9,32,32,12,5,9,14,29,21,10
2022-23,1/2/2023,202301020ANA,Anaheim Ducks,ANA,1,PHI,1,1,2,29,18,10,4,7,11,31,18,11
2022-23,1/2/2023,202301020BOS,Boston Bruins,BOS,1,PIT,2,3,5,26,28,15,1,2,3,27,19,17
2022-23,1/2/2023,202301020COL,Colorado Avalanche,COL,1,VEG,2,4,6,24,21,7,3,6,9,28,24,10
2022-23,1/2/2023,202301020ANA,Philadelphia Flyers,PHI,0,ANA,4,7,11,31,18,11,1,1,2,29,18,10
2022-23,1/2/2023,202301020BOS,Pittsburgh Penguins,PIT,0,BOS,1,2,3,27,19,17,2,3,5,26,28,15
2022-23,1/2/2023,202301020COL,Vegas Golden Knights,VEG,0,COL,3,6,9,28,24,10,2,4,6,24,21,7
2022-23,1/1/2023,202301010CHI,Chicago Blackhawks,CHI,1,SJS,2,2,4,22,22,16,4,9,13,27,12,12
2022-23,1/1/2023,202301010FLA,Florida Panthers,FLA,1,NYR,2,3,5,32,20,14,5,8,13,27,15,13
2022-23,1/1/2023,202301010NJD,Carolina Hurricanes,CAR,0,NJD,2,6,8,42,10,7,4,7,11,27,12,25
2022-23,1/1/2023,202301010OTT,Buffalo Sabres,BUF,0,OTT,1,2,3,34,18,7,3,3,6,30,26,15
2022-23,1/1/2023,202301010SEA,New York Islanders,NYI,0,SEA,1,1,2,16,26,15,4,8,12,35,24,12
2022-23,1/1/2023,202301010CHI,San Jose Sharks,SJS,0,CHI,4,9,13,27,12,12,2,2,4,22,22,16
2022-23,1/1/2023,202301010FLA,New York Rangers,NYR,0,FLA,5,8,13,27,15,13,2,3,5,32,20,14
2022-23,1/1/2023,202301010NJD,New Jersey Devils,NJD,1,CAR,4,7,11,27,12,25,2,6,8,42,10,7
2022-23,1/1/2023,202301010OTT,Ottawa Senators,OTT,1,BUF,3,3,6,30,26,15,1,2,3,34,18,7
2022-23,1/1/2023,202301010SEA,Seattle Kraken,SEA,1,NYI,4,8,12,35,24,12,1,1,2,16,26,15
2022-23,12/31/2022,202212310BOS,Boston Bruins,BOS,1,BUF,2,5,7,32,25,12,4,6,10,25,27,17
2022-23,12/31/2022,202212310CBJ,Columbus Blue Jackets,CBJ,1,CHI,4,5,9,35,13,4,1,2,3,24,18,17
2022-23,12/31/2022,202212310CGY,Calgary Flames,CGY,1,VAN,3,5,8,29,15,10,1,3,4,21,17,7
2022-23,12/31/2022,202212310COL,Colorado Avalanche,COL,1,TOR,2,3,5,24,23,8,6,8,14,32,12,25
2022-23,12/31/2022,202212310DAL,Dallas Stars,DAL,1,SJS,5,7,12,31,32,17,2,4,6,27,23,17
2022-23,12/31/2022,202212310DET,Detroit Red Wings,DET,1,OTT,3,5,8,22,29,21,2,4,6,21,29,15
2022-23,12/31/2022,202212310EDM,Edmonton Oilers,EDM,1,WPG,1,1,2,32,36,7,2,3,5,16,21,17
2022-23,12/31/2022,202212310LAK,Los Angeles Kings,LAK,1,PHI,2,3,5,29,18,11,4,8,12,22,34,18
2022-23,12/31/2022,202212310STL,Minnesota Wild,MIN,0,STL,5,7,12,32,19,18,2,4,6,30,19,15
2022-23,12/31/2022,202212310TBL,Arizona Coyotes,ARI,0,TBL,3,3,6,27,16,7,5,7,12,35,25,7
2022-23,12/31/2022,202212310VEG,Nashville Predators,NSH,0,VEG,4,6,10,37,26,22,5,9,14,28,29,17
2022-23,12/31/2022,202212310WSH,Montreal Canadiens,MTL,0,WSH,2,2,4,33,21,13,9,15,24,38,20,11
2022-23,12/31/2022,202212310BOS,Buffalo Sabres,BUF,0,BOS,4,6,10,25,27,17,2,5,7,32,25,12
2022-23,12/31/2022,202212310CBJ,Chicago Blackhawks,CHI,0,CBJ,1,2,3,24,18,17,4,5,9,35,13,4
2022-23,12/31/2022,202212310CGY,Vancouver Canucks,VAN,0,CGY,1,3,4,21,17,7,3,5,8,29,15,10
2022-23,12/31/2022,202212310COL,Toronto Maple Leafs,TOR,0,COL,6,8,14,32,12,25,2,3,5,24,23,8
2022-23,12/31/2022,202212310DAL,San Jose Sharks,SJS,0,DAL,2,4,6,27,23,17,5,7,12,31,32,17
2022-23,12/31/2022,202212310DET,Ottawa Senators,OTT,0,DET,2,4,6,21,29,15,3,5,8,22,29,21
2022-23,12/31/2022,202212310EDM,Winnipeg Jets,WPG,0,EDM,2,3,5,16,21,17,1,1,2,32,36,7
2022-23,12/31/2022,202212310LAK,Philadelphia Flyers,PHI,0,LAK,4,8,12,22,34,18,2,3,5,29,18,11
2022-23,12/31/2022,202212310STL,St. Louis Blues,STL,1,MIN,2,4,6,30,19,15,5,7,12,32,19,18
2022-23,12/31/2022,202212310TBL,Tampa Bay Lightning,TBL,1,ARI,5,7,12,35,25,7,3,3,6,27,16,7
2022-23,12/31/2022,202212310VEG,Vegas Golden Knights,VEG,1,NSH,5,9,14,28,29,17,4,6,10,37,26,22
2022-23,12/31/2022,202212310WSH,Washington Capitals,WSH,1,MTL,9,15,24,38,20,11,2,2,4,33,21,13
2022-23,12/30/2022,202212300ANA,Anaheim Ducks,ANA,1,NSH,1,2,3,27,14,17,6,9,15,43,23,9
2022-23,12/30/2022,202212300CAR,Carolina Hurricanes,CAR,1,FLA,4,8,12,31,8,13,0,0,0,19,25,9
2022-23,12/30/2022,202212300PIT,New Jersey Devils,NJD,0,PIT,4,8,12,28,25,18,2,2,4,27,34,12
2022-23,12/30/2022,202212300SEA,Edmonton Oilers,EDM,0,SEA,7,12,19,29,13,18,2,4,6,38,29,18
2022-23,12/30/2022,202212300ANA,Nashville Predators,NSH,0,ANA,6,9,15,43,23,9,1,2,3,27,14,17
2022-23,12/30/2022,202212300CAR,Florida Panthers,FLA,0,CAR,0,0,0,19,25,9,4,8,12,31,8,13
2022-23,12/30/2022,202212300PIT,Pittsburgh Penguins,PIT,1,NJD,2,2,4,27,34,12,4,8,12,28,25,18
2022-23,12/30/2022,202212300SEA,Seattle Kraken,SEA,1,EDM,2,4,6,38,29,18,7,12,19,29,13,18
2022-23,12/29/2022,202212290ARI,Arizona Coyotes,ARI,1,TOR,6,6,12,19,24,16,3,6,9,32,27,10
2022-23,12/29/2022,202212290BUF,Buffalo Sabres,BUF,1,DET,6,9,15,35,9,7,3,4,7,29,15,16
2022-23,12/29/2022,202212290COL,Colorado Avalanche,COL,1,LAK,4,5,9,25,21,8,4,8,12,26,22,19
2022-23,12/29/2022,202212290FLA,Florida Panthers,FLA,1,MTL,7,10,17,38,23,11,2,4,6,27,26,15
2022-23,12/29/2022,202212290MIN,Dallas Stars,DAL,0,MIN,4,6,10,43,11,17,1,1,2,24,21,18
2022-23,12/29/2022,202212290NYI,Columbus Blue Jackets,CBJ,0,NYI,1,1,2,18,12,10,2,4,6,33,13,15
2022-23,12/29/2022,202212290SJS,Philadelphia Flyers,PHI,0,SJS,4,7,11,26,25,8,3,6,9,22,20,12
2022-23,12/29/2022,202212290STL,Chicago Blackhawks,CHI,0,STL,1,2,3,20,17,10,2,3,5,26,19,13
2022-23,12/29/2022,202212290TBL,New York Rangers,NYR,0,TBL,1,0,1,43,38,21,1,2,3,40,40,17
2022-23,12/29/2022,202212290WPG,Vancouver Canucks,VAN,0,WPG,2,3,5,21,18,17,4,5,9,37,16,13
2022-23,12/29/2022,202212290WSH,Ottawa Senators,OTT,0,WSH,4,4,8,42,34,11,3,5,8,22,33,11
2022-23,12/29/2022,202212290ARI,Toronto Maple Leafs,TOR,0,ARI,3,6,9,32,27,10,6,6,12,19,24,16
2022-23,12/29/2022,202212290BUF,Detroit Red Wings,DET,0,BUF,3,4,7,29,15,16,6,9,15,35,9,7
2022-23,12/29/2022,202212290COL,Los Angeles Kings,LAK,0,COL,4,8,12,26,22,19,4,5,9,25,21,8
2022-23,12/29/2022,202212290FLA,Montreal Canadiens,MTL,0,FLA,2,4,6,27,26,15,7,10,17,38,23,11
2022-23,12/29/2022,202212290MIN,Minnesota Wild,MIN,1,DAL,1,1,2,24,21,18,4,6,10,43,11,17
2022-23,12/29/2022,202212290NYI,New York Islanders,NYI,1,CBJ,2,4,6,33,13,15,1,1,2,18,12,10
2022-23,12/29/2022,202212290SJS,San Jose Sharks,SJS,1,PHI,3,6,9,22,20,12,4,7,11,26,25,8
2022-23,12/29/2022,202212290STL,St. Louis Blues,STL,1,CHI,2,3,5,26,19,13,1,2,3,20,17,10
2022-23,12/29/2022,202212290TBL,Tampa Bay Lightning,TBL,1,NYR,1,2,3,40,40,17,1,0,1,43,38,21
2022-23,12/29/2022,202212290WPG,Winnipeg Jets,WPG,1,VAN,4,5,9,37,16,13,2,3,5,21,18,17
2022-23,12/29/2022,202212290WSH,Washington Capitals,WSH,1,OTT,3,5,8,22,33,11,4,4,8,42,34,11
2022-23,12/28/2022,202212280ANA,Anaheim Ducks,ANA,1,VEG,2,4,6,27,18,19,2,1,3,48,19,19
2022-23,12/28/2022,202212280NJD,Boston Bruins,BOS,0,NJD,2,5,7,22,16,19,1,2,3,31,15,7
2022-23,12/28/2022,202212280PIT,Detroit Red Wings,DET,0,PIT,5,6,11,46,30,12,4,6,10,31,26,20
2022-23,12/28/2022,202212280SEA,Calgary Flames,CGY,0,SEA,3,6,9,42,19,13,2,3,5,31,25,9
2022-23,12/28/2022,202212280TBL,Montreal Canadiens,MTL,0,TBL,1,2,3,26,25,13,4,5,9,38,26,13
2022-23,12/28/2022,202212280ANA,Vegas Golden Knights,VEG,0,ANA,2,1,3,48,19,19,2,4,6,27,18,19
2022-23,12/28/2022,202212280NJD,New Jersey Devils,NJD,1,BOS,1,2,3,31,15,7,2,5,7,22,16,19
2022-23,12/28/2022,202212280PIT,Pittsburgh Penguins,PIT,1,DET,4,6,10,31,26,20,5,6,11,46,30,12
2022-23,12/28/2022,202212280SEA,Seattle Kraken,SEA,1,CGY,2,3,5,31,25,9,3,6,9,42,19,13
2022-23,12/28/2022,202212280TBL,Tampa Bay Lightning,TBL,1,MTL,4,5,9,38,26,13,1,2,3,26,25,13
2022-23,12/27/2022,202212270ARI,Arizona Coyotes,ARI,1,COL,6,9,15,29,20,16,3,6,9,25,23,9
2022-23,12/27/2022,202212270CAR,Carolina Hurricanes,CAR,1,CHI,3,4,7,45,14,14,0,0,0,23,29,14
2022-23,12/27/2022,202212270CGY,Calgary Flames,CGY,1,EDM,1,2,3,40,19,5,2,3,5,21,12,23
2022-23,12/27/2022,202212270LAK,Los Angeles Kings,LAK,1,VEG,4,6,10,24,20,16,2,4,6,22,21,16
2022-23,12/27/2022,202212270NSH,Dallas Stars,DAL,0,NSH,3,4,7,33,17,16,2,4,6,28,36,21
2022-23,12/27/2022,202212270NYI,New York Islanders,NYI,1,PIT,4,6,10,41,20,14,1,0,1,21,17,19
2022-23,12/27/2022,202212270NYR,New York Rangers,NYR,1,WSH,0,0,0,30,16,5,4,5,9,30,17,14
2022-23,12/27/2022,202212270OTT,Boston Bruins,BOS,0,OTT,2,3,5,40,22,14,2,3,5,31,35,20
2022-23,12/27/2022,202212270STL,St. Louis Blues,STL,1,TOR,4,6,10,34,34,9,5,8,13,36,8,13
2022-23,12/27/2022,202212270VAN,San Jose Sharks,SJS,0,VAN,2,3,5,24,17,14,6,10,16,19,26,15
2022-23,12/27/2022,202212270WPG,Minnesota Wild,MIN,0,WPG,4,8,12,28,22,11,1,2,3,31,30,8
2022-23,12/27/2022,202212270ARI,Colorado Avalanche,COL,0,ARI,3,6,9,25,23,9,6,9,15,29,20,16
2022-23,12/27/2022,202212270CAR,Chicago Blackhawks,CHI,0,CAR,0,0,0,23,29,14,3,4,7,45,14,14
2022-23,12/27/2022,202212270CGY,Edmonton Oilers,EDM,0,CGY,2,3,5,21,12,23,1,2,3,40,19,5
2022-23,12/27/2022,202212270LAK,Vegas Golden Knights,VEG,0,LAK,2,4,6,22,21,16,4,6,10,24,20,16
2022-23,12/27/2022,202212270NSH,Nashville Predators,NSH,1,DAL,2,4,6,28,36,21,3,4,7,33,17,16
2022-23,12/27/2022,202212270NYI,Pittsburgh Penguins,PIT,0,NYI,1,0,1,21,17,19,4,6,10,41,20,14
2022-23,12/27/2022,202212270NYR,Washington Capitals,WSH,0,NYR,4,5,9,30,17,14,0,0,0,30,16,5
2022-23,12/27/2022,202212270OTT,Ottawa Senators,OTT,1,BOS,2,3,5,31,35,20,2,3,5,40,22,14
2022-23,12/27/2022,202212270STL,Toronto Maple Leafs,TOR,0,STL,5,8,13,36,8,13,4,6,10,34,34,9
2022-23,12/27/2022,202212270VAN,Vancouver Canucks,VAN,1,SJS,6,10,16,19,26,15,2,3,5,24,17,14
2022-23,12/27/2022,202212270WPG,Winnipeg Jets,WPG,1,MIN,1,2,3,31,30,8,4,8,12,28,22,11
2022-23,12/23/2022,202212230ANA,Anaheim Ducks,ANA,1,CGY,2,4,6,22,10,15,1,5,6,39,11,13
2022-23,12/23/2022,202212230ARI,Arizona Coyotes,ARI,1,LAK,1,2,3,21,29,9,1,2,3,26,22,18
2022-23,12/23/2022,202212230CAR,Carolina Hurricanes,CAR,1,PHI,6,11,17,36,11,9,5,8,13,31,16,15
2022-23,12/23/2022,202212230CHI,Columbus Blue Jackets,CBJ,0,CHI,1,3,4,23,14,11,4,7,11,36,19,14
2022-23,12/23/2022,202212230DAL,Dallas Stars,DAL,1,MTL,4,5,9,36,16,9,2,3,5,23,25,18
2022-23,12/23/2022,202212230EDM,Edmonton Oilers,EDM,1,VAN,2,3,5,33,26,16,5,9,14,28,19,16
2022-23,12/23/2022,202212230NJD,Boston Bruins,BOS,0,NJD,3,4,7,18,12,21,3,6,9,40,13,15
2022-23,12/23/2022,202212230NSH,Colorado Avalanche,COL,0,NSH,3,4,7,42,24,11,2,4,6,39,27,21
2022-23,12/23/2022,202212230NYI,Florida Panthers,FLA,0,NYI,1,1,2,20,15,17,4,7,11,39,14,15
2022-23,12/23/2022,202212230VEG,St. Louis Blues,STL,0,VEG,4,8,12,27,22,12,4,8,12,31,23,17
2022-23,12/23/2022,202212230WSH,Winnipeg Jets,WPG,0,WSH,1,1,2,25,28,16,4,7,11,26,16,15
2022-23,12/23/2022,202212230ANA,Calgary Flames,CGY,0,ANA,1,5,6,39,11,13,2,4,6,22,10,15
2022-23,12/23/2022,202212230ARI,Los Angeles Kings,LAK,0,ARI,1,2,3,26,22,18,1,2,3,21,29,9
2022-23,12/23/2022,202212230CAR,Philadelphia Flyers,PHI,0,CAR,5,8,13,31,16,15,6,11,17,36,11,9
2022-23,12/23/2022,202212230CHI,Chicago Blackhawks,CHI,1,CBJ,4,7,11,36,19,14,1,3,4,23,14,11
2022-23,12/23/2022,202212230DAL,Montreal Canadiens,MTL,0,DAL,2,3,5,23,25,18,4,5,9,36,16,9
2022-23,12/23/2022,202212230EDM,Vancouver Canucks,VAN,0,EDM,5,9,14,28,19,16,2,3,5,33,26,16
2022-23,12/23/2022,202212230NJD,New Jersey Devils,NJD,1,BOS,3,6,9,40,13,15,3,4,7,18,12,21
2022-23,12/23/2022,202212230NSH,Nashville Predators,NSH,1,COL,2,4,6,39,27,21,3,4,7,42,24,11
2022-23,12/23/2022,202212230NYI,New York Islanders,NYI,1,FLA,4,7,11,39,14,15,1,1,2,20,15,17
2022-23,12/23/2022,202212230VEG,Vegas Golden Knights,VEG,1,STL,4,8,12,31,23,17,4,8,12,27,22,12
2022-23,12/23/2022,202212230WSH,Washington Capitals,WSH,1,WPG,4,7,11,26,16,15,1,1,2,25,28,16
2022-23,12/22/2022,202212220BOS,Boston Bruins,BOS,1,WPG,3,6,9,34,18,10,2,3,5,23,24,8
2022-23,12/22/2022,202212220LAK,Calgary Flames,CGY,0,LAK,3,5,8,29,28,11,4,5,9,31,20,19
2022-23,12/22/2022,202212220NYR,New York Islanders,NYI,0,NYR,3,3,6,18,25,12,5,8,13,33,16,13
2022-23,12/22/2022,202212220OTT,Ottawa Senators,OTT,1,WSH,2,3,5,22,25,13,3,6,9,37,11,24
2022-23,12/22/2022,202212220PIT,Carolina Hurricanes,CAR,0,PIT,4,7,11,32,20,7,3,5,8,27,38,26
2022-23,12/22/2022,202212220SJS,Minnesota Wild,MIN,0,SJS,2,3,5,26,15,20,5,8,13,25,15,12
2022-23,12/22/2022,202212220TOR,Philadelphia Flyers,PHI,0,TOR,3,5,8,18,32,10,4,8,12,32,21,10
2022-23,12/22/2022,202212220VAN,Seattle Kraken,SEA,0,VAN,5,8,13,36,12,19,4,8,12,33,23,18
2022-23,12/22/2022,202212220BOS,Winnipeg Jets,WPG,0,BOS,2,3,5,23,24,8,3,6,9,34,18,10
2022-23,12/22/2022,202212220LAK,Los Angeles Kings,LAK,1,CGY,4,5,9,31,20,19,3,5,8,29,28,11
2022-23,12/22/2022,202212220NYR,New York Rangers,NYR,1,NYI,5,8,13,33,16,13,3,3,6,18,25,12
2022-23,12/22/2022,202212220OTT,Washington Capitals,WSH,0,OTT,3,6,9,37,11,24,2,3,5,22,25,13
2022-23,12/22/2022,202212220PIT,Pittsburgh Penguins,PIT,1,CAR,3,5,8,27,38,26,4,7,11,32,20,7
2022-23,12/22/2022,202212220SJS,San Jose Sharks,SJS,1,MIN,5,8,13,25,15,12,2,3,5,26,15,20
2022-23,12/22/2022,202212220TOR,Toronto Maple Leafs,TOR,1,PHI,4,8,12,32,21,10,3,5,8,18,32,10
2022-23,12/22/2022,202212220VAN,Vancouver Canucks,VAN,1,SEA,4,8,12,33,23,18,5,8,13,36,12,19
2022-23,12/21/2022,202212210ANA,Anaheim Ducks,ANA,1,MIN,1,0,1,22,14,16,4,6,10,42,15,8
2022-23,12/21/2022,202212210CHI,Chicago Blackhawks,CHI,1,NSH,2,3,5,37,26,16,4,8,12,37,20,13
2022-23,12/21/2022,202212210COL,Colorado Avalanche,COL,1,MTL,2,3,5,31,21,15,1,2,3,19,22,19
2022-23,12/21/2022,202212210DAL,Dallas Stars,DAL,1,EDM,3,6,9,27,22,15,6,10,16,33,24,11
2022-23,12/21/2022,202212210DET,Detroit Red Wings,DET,1,TBL,6,9,15,30,18,18,4,6,10,38,17,14
2022-23,12/21/2022,202212210FLA,Florida Panthers,FLA,1,NJD,1,4,5,30,15,10,4,5,9,32,16,27
2022-23,12/21/2022,202212210VEG,Arizona Coyotes,ARI,0,VEG,2,3,5,23,26,21,5,8,13,31,17,14
2022-23,12/21/2022,202212210ANA,Minnesota Wild,MIN,0,ANA,4,6,10,42,15,8,1,0,1,22,14,16
2022-23,12/21/2022,202212210CHI,Nashville Predators,NSH,0,CHI,4,8,12,37,20,13,2,3,5,37,26,16
2022-23,12/21/2022,202212210COL,Montreal Canadiens,MTL,0,COL,1,2,3,19,22,19,2,3,5,31,21,15
2022-23,12/21/2022,202212210DAL,Edmonton Oilers,EDM,0,DAL,6,10,16,33,24,11,3,6,9,27,22,15
2022-23,12/21/2022,202212210DET,Tampa Bay Lightning,TBL,0,DET,4,6,10,38,17,14,6,9,15,30,18,18
2022-23,12/21/2022,202212210FLA,New Jersey Devils,NJD,0,FLA,4,5,9,32,16,27,1,4,5,30,15,10
2022-23,12/21/2022,202212210VEG,Vegas Golden Knights,VEG,1,ARI,5,8,13,31,17,14,2,3,5,23,26,21
2022-23,12/20/2022,202212200CAR,Carolina Hurricanes,CAR,1,NJD,4,6,10,19,19,12,1,2,3,38,24,10
2022-23,12/20/2022,202212200LAK,Anaheim Ducks,ANA,0,LAK,1,2,3,25,21,14,4,7,11,40,17,16
2022-23,12/20/2022,202212200PHI,Columbus Blue Jackets,CBJ,0,PHI,3,6,9,26,16,14,5,5,10,35,25,10
2022-23,12/20/2022,202212200PIT,New York Rangers,NYR,0,PIT,2,3,5,27,25,11,3,5,8,24,32,21
2022-23,12/20/2022,202212200SEA,Seattle Kraken,SEA,1,STL,5,8,13,33,17,20,2,3,5,24,18,10
2022-23,12/20/2022,202212200SJS,Calgary Flames,CGY,0,SJS,7,11,18,38,14,13,3,3,6,26,15,14
2022-23,12/20/2022,202212200TOR,Tampa Bay Lightning,TBL,0,TOR,1,1,2,19,33,5,4,6,10,40,20,14
2022-23,12/20/2022,202212200WPG,Ottawa Senators,OTT,0,WPG,1,2,3,33,29,9,5,10,15,23,21,15
2022-23,12/20/2022,202212200CAR,New Jersey Devils,NJD,0,CAR,1,2,3,38,24,10,4,6,10,19,19,12
2022-23,12/20/2022,202212200LAK,Los Angeles Kings,LAK,1,ANA,4,7,11,40,17,16,1,2,3,25,21,14
2022-23,12/20/2022,202212200PHI,Philadelphia Flyers,PHI,1,CBJ,5,5,10,35,25,10,3,6,9,26,16,14
2022-23,12/20/2022,202212200PIT,Pittsburgh Penguins,PIT,1,NYR,3,5,8,24,32,21,2,3,5,27,25,11
2022-23,12/20/2022,202212200SEA,St. Louis Blues,STL,0,SEA,2,3,5,24,18,10,5,8,13,33,17,20
2022-23,12/20/2022,202212200SJS,San Jose Sharks,SJS,1,CGY,3,3,6,26,15,14,7,11,18,38,14,13
2022-23,12/20/2022,202212200TOR,Toronto Maple Leafs,TOR,1,TBL,4,6,10,40,20,14,1,1,2,19,33,5
2022-23,12/20/2022,202212200WPG,Winnipeg Jets,WPG,1,OTT,5,10,15,23,21,15,1,2,3,33,29,9
2022-23,12/19/2022,202212190ARI,Arizona Coyotes,ARI,1,MTL,2,3,5,35,15,9,3,6,9,25,19,13
2022-23,12/19/2022,202212190BOS,Boston Bruins,BOS,1,FLA,4,10,14,20,9,13,2,5,7,30,13,11
2022-23,12/19/2022,202212190CBJ,Columbus Blue Jackets,CBJ,1,DAL,1,2,3,25,29,15,2,2,4,34,9,12
2022-23,12/19/2022,202212190COL,Colorado Avalanche,COL,1,NYI,0,0,0,43,23,13,0,0,0,24,22,25
2022-23,12/19/2022,202212190NSH,Edmonton Oilers,EDM,0,NSH,3,4,7,33,18,9,3,7,10,32,18,15
2022-23,12/19/2022,202212190VAN,St. Louis Blues,STL,0,VAN,5,10,15,27,17,6,1,1,2,30,24,8
2022-23,12/19/2022,202212190VEG,Buffalo Sabres,BUF,0,VEG,2,3,5,17,16,15,2,4,6,42,13,9
2022-23,12/19/2022,202212190WSH,Detroit Red Wings,DET,0,WSH,3,6,9,19,24,14,4,8,12,39,17,17
2022-23,12/19/2022,202212190ARI,Montreal Canadiens,MTL,0,ARI,3,6,9,25,19,13,2,3,5,35,15,9
2022-23,12/19/2022,202212190BOS,Florida Panthers,FLA,0,BOS,2,5,7,30,13,11,4,10,14,20,9,13
2022-23,12/19/2022,202212190CBJ,Dallas Stars,DAL,0,CBJ,2,2,4,34,9,12,1,2,3,25,29,15
2022-23,12/19/2022,202212190COL,New York Islanders,NYI,0,COL,0,0,0,24,22,25,0,0,0,43,23,13
2022-23,12/19/2022,202212190NSH,Nashville Predators,NSH,1,EDM,3,7,10,32,18,15,3,4,7,33,18,9
2022-23,12/19/2022,202212190VAN,Vancouver Canucks,VAN,1,STL,1,1,2,30,24,8,5,10,15,27,17,6
2022-23,12/19/2022,202212190VEG,Vegas Golden Knights,VEG,1,BUF,2,4,6,42,13,9,2,3,5,17,16,15
2022-23,12/19/2022,202212190WSH,Washington Capitals,WSH,1,DET,4,8,12,39,17,17,3,6,9,19,24,14
2022-23,12/18/2022,202212180CAR,Carolina Hurricanes,CAR,1,PIT,2,4,6,27,17,10,2,3,5,24,25,12
2022-23,12/18/2022,202212180CHI,Chicago Blackhawks,CHI,1,NYR,1,0,1,28,24,7,6,14,20,24,14,13
2022-23,12/18/2022,202212180MIN,Minnesota Wild,MIN,1,OTT,4,6,10,23,16,19,2,4,6,26,23,13
2022-23,12/18/2022,202212180SEA,Seattle Kraken,SEA,1,WPG,3,6,9,34,22,12,2,4,6,17,13,13
2022-23,12/18/2022,202212180SJS,Calgary Flames,CGY,0,SJS,5,8,13,25,20,5,2,4,6,24,22,9
2022-23,12/18/2022,202212180CAR,Pittsburgh Penguins,PIT,0,CAR,2,3,5,24,25,12,2,4,6,27,17,10
2022-23,12/18/2022,202212180CHI,New York Rangers,NYR,0,CHI,6,14,20,24,14,13,1,0,1,28,24,7
2022-23,12/18/2022,202212180MIN,Ottawa Senators,OTT,0,MIN,2,4,6,26,23,13,4,6,10,23,16,19
2022-23,12/18/2022,202212180SEA,Winnipeg Jets,WPG,0,SEA,2,4,6,17,13,13,3,6,9,34,22,12
2022-23,12/18/2022,202212180SJS,San Jose Sharks,SJS,1,CGY,2,4,6,24,22,9,5,8,13,25,20,5
2022-23,12/17/2022,202212170ARI,Arizona Coyotes,ARI,1,BUF,2,2,4,31,25,12,5,8,13,42,15,9
2022-23,12/17/2022,202212170BOS,Boston Bruins,BOS,1,CBJ,3,7,10,34,17,12,2,3,5,32,23,19
2022-23,12/17/2022,202212170CAR,Carolina Hurricanes,CAR,1,DAL,5,8,13,34,19,16,4,6,10,30,14,17
2022-23,12/17/2022,202212170COL,Colorado Avalanche,COL,1,NSH,3,3,6,30,17,17,1,1,2,23,23,15
2022-23,12/17/2022,202212170DET,Detroit Red Wings,DET,1,OTT,3,5,8,31,11,15,6,8,14,27,15,13
2022-23,12/17/2022,202212170EDM,Anaheim Ducks,ANA,0,EDM,4,6,10,17,18,13,3,6,9,48,23,9
2022-23,12/17/2022,202212170LAK,Los Angeles Kings,LAK,1,SJS,2,3,5,41,23,15,2,3,5,21,30,18
2022-23,12/17/2022,202212170MTL,Montreal Canadiens,MTL,1,TBL,1,1,2,23,16,12,5,9,14,27,17,13
2022-23,12/17/2022,202212170NJD,Florida Panthers,FLA,0,NJD,4,6,10,26,27,18,2,4,6,32,12,16
2022-23,12/17/2022,202212170PHI,New York Rangers,NYR,0,PHI,6,7,13,32,19,17,3,3,6,32,21,9
2022-23,12/17/2022,202212170VAN,Vancouver Canucks,VAN,1,WPG,1,2,3,22,34,4,4,9,13,22,8,16
2022-23,12/17/2022,202212170VEG,New York Islanders,NYI,0,VEG,5,7,12,22,25,15,2,2,4,34,13,13
2022-23,12/17/2022,202212170WSH,Toronto Maple Leafs,TOR,0,WSH,2,4,6,36,17,10,5,9,14,27,35,18
2022-23,12/17/2022,202212170ARI,Buffalo Sabres,BUF,0,ARI,5,8,13,42,15,9,2,2,4,31,25,12
2022-23,12/17/2022,202212170BOS,Columbus Blue Jackets,CBJ,0,BOS,2,3,5,32,23,19,3,7,10,34,17,12
2022-23,12/17/2022,202212170CAR,Dallas Stars,DAL,0,CAR,4,6,10,30,14,17,5,8,13,34,19,16
2022-23,12/17/2022,202212170COL,Nashville Predators,NSH,0,COL,1,1,2,23,23,15,3,3,6,30,17,17
2022-23,12/17/2022,202212170DET,Ottawa Senators,OTT,0,DET,6,8,14,27,15,13,3,5,8,31,11,15
2022-23,12/17/2022,202212170EDM,Edmonton Oilers,EDM,1,ANA,3,6,9,48,23,9,4,6,10,17,18,13
2022-23,12/17/2022,202212170LAK,San Jose Sharks,SJS,0,LAK,2,3,5,21,30,18,2,3,5,41,23,15
2022-23,12/17/2022,202212170MTL,Tampa Bay Lightning,TBL,0,MTL,5,9,14,27,17,13,1,1,2,23,16,12
2022-23,12/17/2022,202212170NJD,New Jersey Devils,NJD,1,FLA,2,4,6,32,12,16,4,6,10,26,27,18
2022-23,12/17/2022,202212170PHI,Philadelphia Flyers,PHI,1,NYR,3,3,6,32,21,9,6,7,13,32,19,17
2022-23,12/17/2022,202212170VAN,Winnipeg Jets,WPG,0,VAN,4,9,13,22,8,16,1,2,3,22,34,4
2022-23,12/17/2022,202212170VEG,Vegas Golden Knights,VEG,1,NYI,2,2,4,34,13,13,5,7,12,22,25,15
2022-23,12/17/2022,202212170WSH,Washington Capitals,WSH,1,TOR,5,9,14,27,35,18,2,4,6,36,17,10
2022-23,12/16/2022,202212160ARI,Arizona Coyotes,ARI,1,NYI,5,8,13,25,31,15,4,4,8,33,22,16
2022-23,12/16/2022,202212160CGY,Calgary Flames,CGY,1,STL,2,4,6,41,13,8,5,7,12,23,11,14
2022-23,12/16/2022,202212160MIN,Chicago Blackhawks,CHI,0,MIN,0,2,2,26,13,17,4,8,12,22,20,12
2022-23,12/16/2022,202212160ARI,New York Islanders,NYI,0,ARI,4,4,8,33,22,16,5,8,13,25,31,15
2022-23,12/16/2022,202212160CGY,St. Louis Blues,STL,0,CGY,5,7,12,23,11,14,2,4,6,41,13,8
2022-23,12/16/2022,202212160MIN,Minnesota Wild,MIN,1,CHI,4,8,12,22,20,12,0,2,2,26,13,17
2022-23,12/15/2022,202212150BOS,Boston Bruins,BOS,1,LAK,2,4,6,28,21,14,2,4,6,28,9,14
2022-23,12/15/2022,202212150CAR,Carolina Hurricanes,CAR,1,SEA,2,2,4,36,17,11,2,4,6,17,28,16
2022-23,12/15/2022,202212150CHI,Chicago Blackhawks,CHI,1,VEG,1,1,2,23,23,10,3,7,10,21,20,16
2022-23,12/15/2022,202212150COL,Buffalo Sabres,BUF,0,COL,4,6,10,20,8,20,2,4,6,40,21,4
2022-23,12/15/2022,202212150EDM,Edmonton Oilers,EDM,1,STL,3,5,8,27,14,14,3,5,8,32,25,10
2022-23,12/15/2022,202212150FLA,Florida Panthers,FLA,1,PIT,2,2,4,27,11,4,4,8,12,37,9,9
2022-23,12/15/2022,202212150MTL,Anaheim Ducks,ANA,0,MTL,5,8,13,31,12,16,2,4,6,23,13,5
2022-23,12/15/2022,202212150NJD,New Jersey Devils,NJD,1,PHI,1,1,2,49,11,18,2,3,5,23,15,18
2022-23,12/15/2022,202212150NYR,New York Rangers,NYR,1,TOR,3,6,9,19,14,12,1,2,3,22,8,10
2022-23,12/15/2022,202212150TBL,Columbus Blue Jackets,CBJ,0,TBL,1,2,3,24,32,15,4,8,12,29,23,17
2022-23,12/15/2022,202212150WPG,Nashville Predators,NSH,0,WPG,1,2,3,25,22,15,2,3,5,41,18,10
2022-23,12/15/2022,202212150WSH,Dallas Stars,DAL,0,WSH,2,4,6,26,15,14,1,2,3,45,23,10
2022-23,12/15/2022,202212150BOS,Los Angeles Kings,LAK,0,BOS,2,4,6,28,9,14,2,4,6,28,21,14
2022-23,12/15/2022,202212150CAR,Seattle Kraken,SEA,0,CAR,2,4,6,17,28,16,2,2,4,36,17,11
2022-23,12/15/2022,202212150CHI,Vegas Golden Knights,VEG,0,CHI,3,7,10,21,20,16,1,1,2,23,23,10
2022-23,12/15/2022,202212150COL,Colorado Avalanche,COL,1,BUF,2,4,6,40,21,4,4,6,10,20,8,20
2022-23,12/15/2022,202212150EDM,St. Louis Blues,STL,0,EDM,3,5,8,32,25,10,3,5,8,27,14,14
2022-23,12/15/2022,202212150FLA,Pittsburgh Penguins,PIT,0,FLA,4,8,12,37,9,9,2,2,4,27,11,4
2022-23,12/15/2022,202212150MTL,Montreal Canadiens,MTL,1,ANA,2,4,6,23,13,5,5,8,13,31,12,16
2022-23,12/15/2022,202212150NJD,Philadelphia Flyers,PHI,0,NJD,2,3,5,23,15,18,1,1,2,49,11,18
2022-23,12/15/2022,202212150NYR,Toronto Maple Leafs,TOR,0,NYR,1,2,3,22,8,10,3,6,9,19,14,12
2022-23,12/15/2022,202212150TBL,Tampa Bay Lightning,TBL,1,CBJ,4,8,12,29,23,17,1,2,3,24,32,15
2022-23,12/15/2022,202212150WPG,Winnipeg Jets,WPG,1,NSH,2,3,5,41,18,10,1,2,3,25,22,15
2022-23,12/15/2022,202212150WSH,Washington Capitals,WSH,1,DAL,1,2,3,45,23,10,2,4,6,26,15,14
2022-23,12/14/2022,202212140CGY,Calgary Flames,CGY,1,VAN,3,5,8,38,9,16,2,6,8,25,25,13
2022-23,12/14/2022,202212140MIN,Detroit Red Wings,DET,0,MIN,0,1,1,15,24,11,4,6,10,22,25,17
2022-23,12/14/2022,202212140OTT,Montreal Canadiens,MTL,0,OTT,2,4,6,24,29,11,3,6,9,28,29,8
2022-23,12/14/2022,202212140CGY,Vancouver Canucks,VAN,0,CGY,2,6,8,25,25,13,3,5,8,38,9,16
2022-23,12/14/2022,202212140MIN,Minnesota Wild,MIN,1,DET,4,6,10,22,25,17,0,1,1,15,24,11
2022-23,12/14/2022,202212140OTT,Ottawa Senators,OTT,1,MTL,3,6,9,28,29,8,2,4,6,24,29,11
2022-23,12/13/2022,202212130BOS,Boston Bruins,BOS,1,NYI,3,6,9,30,30,21,2,4,6,24,31,13
2022-23,12/13/2022,202212130BUF,Buffalo Sabres,BUF,1,LAK,6,9,15,29,10,7,0,0,0,40,19,22
2022-23,12/13/2022,202212130CHI,Chicago Blackhawks,CHI,1,WSH,2,5,7,25,25,21,7,13,20,30,13,11
2022-23,12/13/2022,202212130COL,Colorado Avalanche,COL,1,PHI,3,4,7,23,18,10,2,2,4,27,26,18
2022-23,12/13/2022,202212130DET,Carolina Hurricanes,CAR,0,DET,1,2,3,21,13,10,0,0,0,27,16,15
2022-23,12/13/2022,202212130FLA,Columbus Blue Jackets,CBJ,0,FLA,0,0,0,21,20,9,4,6,10,22,14,11
2022-23,12/13/2022,202212130NJD,Dallas Stars,DAL,0,NJD,4,4,8,32,19,23,1,2,3,36,9,15
2022-23,12/13/2022,202212130NSH,Edmonton Oilers,EDM,0,NSH,6,12,18,37,22,15,3,6,9,26,29,7
2022-23,12/13/2022,202212130SJS,Arizona Coyotes,ARI,0,SJS,2,3,5,19,13,10,3,3,6,29,10,12
2022-23,12/13/2022,202212130TBL,Seattle Kraken,SEA,0,TBL,2,2,4,38,39,10,6,12,18,30,27,16
2022-23,12/13/2022,202212130TOR,Anaheim Ducks,ANA,0,TOR,0,0,0,27,29,11,7,14,21,41,14,2
2022-23,12/13/2022,202212130WPG,Vegas Golden Knights,VEG,0,WPG,6,11,17,32,18,14,5,9,14,34,33,17
2022-23,12/13/2022,202212130BOS,New York Islanders,NYI,0,BOS,2,4,6,24,31,13,3,6,9,30,30,21
2022-23,12/13/2022,202212130BUF,Los Angeles Kings,LAK,0,BUF,0,0,0,40,19,22,6,9,15,29,10,7
2022-23,12/13/2022,202212130CHI,Washington Capitals,WSH,0,CHI,7,13,20,30,13,11,2,5,7,25,25,21
2022-23,12/13/2022,202212130COL,Philadelphia Flyers,PHI,0,COL,2,2,4,27,26,18,3,4,7,23,18,10
2022-23,12/13/2022,202212130DET,Detroit Red Wings,DET,1,CAR,0,0,0,27,16,15,1,2,3,21,13,10
2022-23,12/13/2022,202212130FLA,Florida Panthers,FLA,1,CBJ,4,6,10,22,14,11,0,0,0,21,20,9
2022-23,12/13/2022,202212130NJD,New Jersey Devils,NJD,1,DAL,1,2,3,36,9,15,4,4,8,32,19,23
2022-23,12/13/2022,202212130NSH,Nashville Predators,NSH,1,EDM,3,6,9,26,29,7,6,12,18,37,22,15
2022-23,12/13/2022,202212130SJS,San Jose Sharks,SJS,1,ARI,3,3,6,29,10,12,2,3,5,19,13,10
2022-23,12/13/2022,202212130TBL,Tampa Bay Lightning,TBL,1,SEA,6,12,18,30,27,16,2,2,4,38,39,10
2022-23,12/13/2022,202212130TOR,Toronto Maple Leafs,TOR,1,ANA,7,14,21,41,14,2,0,0,0,27,29,11
2022-23,12/13/2022,202212130WPG,Winnipeg Jets,WPG,1,VEG,5,9,14,34,33,17,6,11,17,32,18,14
2022-23,12/12/2022,202212120MIN,Edmonton Oilers,EDM,0,MIN,1,2,3,21,11,7,2,3,5,30,15,13
2022-23,12/12/2022,202212120MTL,Calgary Flames,CGY,0,MTL,1,2,3,27,22,19,1,2,3,38,24,18
2022-23,12/12/2022,202212120NYR,New Jersey Devils,NJD,0,NYR,3,3,6,29,19,10,4,8,12,22,32,11
2022-23,12/12/2022,202212120OTT,Anaheim Ducks,ANA,0,OTT,0,0,0,32,28,16,3,5,8,37,22,21
2022-23,12/12/2022,202212120PIT,Dallas Stars,DAL,0,PIT,1,1,2,27,33,19,2,4,6,24,33,22
2022-23,12/12/2022,202212120STL,Nashville Predators,NSH,0,STL,0,0,0,25,27,13,1,2,3,24,29,18
2022-23,12/12/2022,202212120MIN,Minnesota Wild,MIN,1,EDM,2,3,5,30,15,13,1,2,3,21,11,7
2022-23,12/12/2022,202212120MTL,Montreal Canadiens,MTL,1,CGY,1,2,3,38,24,18,1,2,3,27,22,19
2022-23,12/12/2022,202212120NYR,New York Rangers,NYR,1,NJD,4,8,12,22,32,11,3,3,6,29,19,10
2022-23,12/12/2022,202212120OTT,Ottawa Senators,OTT,1,ANA,3,5,8,37,22,21,0,0,0,32,28,16
2022-23,12/12/2022,202212120PIT,Pittsburgh Penguins,PIT,1,DAL,2,4,6,24,33,22,1,1,2,27,33,19
2022-23,12/12/2022,202212120STL,St. Louis Blues,STL,1,NSH,1,2,3,24,29,18,0,0,0,25,27,13
2022-23,12/11/2022,202212110ARI,Arizona Coyotes,ARI,1,PHI,4,7,11,26,25,14,4,7,11,37,23,12
2022-23,12/11/2022,202212110CBJ,Columbus Blue Jackets,CBJ,1,LAK,6,11,17,25,22,12,5,6,11,35,11,17
2022-23,12/11/2022,202212110FLA,Florida Panthers,FLA,1,SEA,1,2,3,24,20,11,5,8,13,32,22,10
2022-23,12/11/2022,202212110STL,Colorado Avalanche,COL,0,STL,3,5,8,27,17,11,2,2,4,31,23,11
2022-23,12/11/2022,202212110VEG,Boston Bruins,BOS,0,VEG,2,5,7,24,42,18,1,2,3,31,26,21
2022-23,12/11/2022,202212110WPG,Winnipeg Jets,WPG,1,WSH,2,4,6,31,15,13,5,7,12,36,12,19
2022-23,12/11/2022,202212110ARI,Philadelphia Flyers,PHI,0,ARI,4,7,11,37,23,12,4,7,11,26,25,14
2022-23,12/11/2022,202212110CBJ,Los Angeles Kings,LAK,0,CBJ,5,6,11,35,11,17,6,11,17,25,22,12
2022-23,12/11/2022,202212110FLA,Seattle Kraken,SEA,0,FLA,5,8,13,32,22,10,1,2,3,24,20,11
2022-23,12/11/2022,202212110STL,St. Louis Blues,STL,1,COL,2,2,4,31,23,11,3,5,8,27,17,11
2022-23,12/11/2022,202212110VEG,Vegas Golden Knights,VEG,1,BOS,1,2,3,31,26,21,2,5,7,24,42,18
2022-23,12/11/2022,202212110WPG,Washington Capitals,WSH,0,WPG,5,7,12,36,12,19,2,4,6,31,15,13
2022-23,12/10/2022,202212100DAL,Dallas Stars,DAL,1,DET,3,5,8,33,13,11,2,3,5,26,27,14
2022-23,12/10/2022,202212100MTL,Los Angeles Kings,LAK,0,MTL,3,4,7,34,13,18,2,4,6,21,24,10
2022-23,12/10/2022,202212100NSH,Nashville Predators,NSH,1,OTT,2,4,6,27,32,16,3,4,7,31,24,15
2022-23,12/10/2022,202212100NYI,Carolina Hurricanes,CAR,0,NYI,2,6,8,28,19,17,0,0,0,15,24,29
2022-23,12/10/2022,202212100PIT,Buffalo Sabres,BUF,0,PIT,1,1,2,36,34,7,3,6,9,28,38,16
2022-23,12/10/2022,202212100TBL,Florida Panthers,FLA,0,TBL,0,1,1,23,25,11,4,8,12,38,24,19
2022-23,12/10/2022,202212100TOR,Calgary Flames,CGY,0,TOR,4,7,11,26,32,13,5,9,14,30,21,10
2022-23,12/10/2022,202212100VAN,Minnesota Wild,MIN,0,VAN,3,3,6,33,13,22,0,0,0,35,23,13
2022-23,12/10/2022,202212100DAL,Detroit Red Wings,DET,0,DAL,2,3,5,26,27,14,3,5,8,33,13,11
2022-23,12/10/2022,202212100MTL,Montreal Canadiens,MTL,1,LAK,2,4,6,21,24,10,3,4,7,34,13,18
2022-23,12/10/2022,202212100NSH,Ottawa Senators,OTT,0,NSH,3,4,7,31,24,15,2,4,6,27,32,16
2022-23,12/10/2022,202212100NYI,New York Islanders,NYI,1,CAR,0,0,0,15,24,29,2,6,8,28,19,17
2022-23,12/10/2022,202212100PIT,Pittsburgh Penguins,PIT,1,BUF,3,6,9,28,38,16,1,1,2,36,34,7
2022-23,12/10/2022,202212100TBL,Tampa Bay Lightning,TBL,1,FLA,4,8,12,38,24,19,0,1,1,23,25,11
2022-23,12/10/2022,202212100TOR,Toronto Maple Leafs,TOR,1,CGY,5,9,14,30,21,10,4,7,11,26,32,13
2022-23,12/10/2022,202212100VAN,Vancouver Canucks,VAN,1,MIN,0,0,0,35,23,13,3,3,6,33,13,22
2022-23,12/9/2022,202212090ANA,Anaheim Ducks,ANA,1,SJS,1,2,3,24,13,9,5,10,15,24,11,8
2022-23,12/9/2022,202212090ARI,Arizona Coyotes,ARI,1,BOS,4,7,11,15,34,14,3,3,6,43,25,7
2022-23,12/9/2022,202212090BUF,Buffalo Sabres,BUF,1,PIT,3,6,9,31,13,12,4,7,11,33,17,10
2022-23,12/9/2022,202212090CBJ,Columbus Blue Jackets,CBJ,1,CGY,3,4,7,24,10,14,0,2,2,30,10,5
2022-23,12/9/2022,202212090CHI,Chicago Blackhawks,CHI,1,WPG,1,1,2,21,21,16,3,5,8,32,13,15
2022-23,12/9/2022,202212090COL,Colorado Avalanche,COL,1,NYR,1,2,3,38,22,13,1,2,3,29,22,14
2022-23,12/9/2022,202212090EDM,Edmonton Oilers,EDM,1,MIN,5,10,15,38,22,15,2,2,4,44,24,13
2022-23,12/9/2022,202212090NJD,New Jersey Devils,NJD,1,NYI,4,8,12,29,11,15,6,8,14,30,20,23
2022-23,12/9/2022,202212090VEG,Philadelphia Flyers,PHI,0,VEG,1,0,1,26,32,20,2,0,2,32,23,14
2022-23,12/9/2022,202212090WSH,Seattle Kraken,SEA,0,WSH,1,1,2,26,28,10,4,6,10,36,19,16
2022-23,12/9/2022,202212090ANA,San Jose Sharks,SJS,0,ANA,5,10,15,24,11,8,1,2,3,24,13,9
2022-23,12/9/2022,202212090ARI,Boston Bruins,BOS,0,ARI,3,3,6,43,25,7,4,7,11,15,34,14
2022-23,12/9/2022,202212090BUF,Pittsburgh Penguins,PIT,0,BUF,4,7,11,33,17,10,3,6,9,31,13,12
2022-23,12/9/2022,202212090CBJ,Calgary Flames,CGY,0,CBJ,0,2,2,30,10,5,3,4,7,24,10,14
2022-23,12/9/2022,202212090CHI,Winnipeg Jets,WPG,0,CHI,3,5,8,32,13,15,1,1,2,21,21,16
2022-23,12/9/2022,202212090COL,New York Rangers,NYR,0,COL,1,2,3,29,22,14,1,2,3,38,22,13
2022-23,12/9/2022,202212090EDM,Minnesota Wild,MIN,0,EDM,2,2,4,44,24,13,5,10,15,38,22,15
2022-23,12/9/2022,202212090NJD,New York Islanders,NYI,0,NJD,6,8,14,30,20,23,4,8,12,29,11,15
2022-23,12/9/2022,202212090VEG,Vegas Golden Knights,VEG,1,PHI,2,0,2,32,23,14,1,0,1,26,32,20
2022-23,12/9/2022,202212090WSH,Washington Capitals,WSH,1,SEA,4,6,10,36,19,16,1,1,2,26,28,10
2022-23,12/8/2022,202212080DAL,Dallas Stars,DAL,1,OTT,4,6,10,32,21,24,2,5,7,30,18,18
2022-23,12/8/2022,202212080FLA,Detroit Red Wings,DET,0,FLA,1,2,3,20,20,17,4,8,12,38,13,10
2022-23,12/8/2022,202212080STL,St. Louis Blues,STL,1,WPG,1,4,5,28,19,14,5,10,15,20,20,18
2022-23,12/8/2022,202212080TBL,Nashville Predators,NSH,0,TBL,2,2,4,35,42,10,5,8,13,33,35,16
2022-23,12/8/2022,202212080TOR,Los Angeles Kings,LAK,0,TOR,0,0,0,28,37,7,5,8,13,38,22,15
2022-23,12/8/2022,202212080DAL,Ottawa Senators,OTT,0,DAL,2,5,7,30,18,18,4,6,10,32,21,24
2022-23,12/8/2022,202212080FLA,Florida Panthers,FLA,1,DET,4,8,12,38,13,10,1,2,3,20,20,17
2022-23,12/8/2022,202212080STL,Winnipeg Jets,WPG,0,STL,5,10,15,20,20,18,1,4,5,28,19,14
2022-23,12/8/2022,202212080TBL,Tampa Bay Lightning,TBL,1,NSH,5,8,13,33,35,16,2,2,4,35,42,10
2022-23,12/8/2022,202212080TOR,Toronto Maple Leafs,TOR,1,LAK,5,8,13,38,22,15,0,0,0,28,37,7
2022-23,12/7/2022,202212070CBJ,Buffalo Sabres,BUF,0,CBJ,9,15,24,29,8,10,4,5,9,23,18,9
2022-23,12/7/2022,202212070CGY,Calgary Flames,CGY,1,MIN,5,10,15,23,12,13,3,6,9,28,14,12
2022-23,12/7/2022,202212070COL,Boston Bruins,BOS,0,COL,4,6,10,32,14,8,0,0,0,19,19,13
2022-23,12/7/2022,202212070EDM,Arizona Coyotes,ARI,0,EDM,2,3,5,18,23,12,8,14,22,35,14,8
2022-23,12/7/2022,202212070PHI,Philadelphia Flyers,PHI,1,WSH,1,2,3,27,31,20,4,8,12,27,17,9
2022-23,12/7/2022,202212070SJS,San Jose Sharks,SJS,1,VAN,5,7,12,35,14,15,6,10,16,26,14,27
2022-23,12/7/2022,202212070VEG,New York Rangers,NYR,0,VEG,5,10,15,37,31,23,1,2,3,26,22,13
2022-23,12/7/2022,202212070CBJ,Columbus Blue Jackets,CBJ,1,BUF,4,5,9,23,18,9,9,15,24,29,8,10
2022-23,12/7/2022,202212070CGY,Minnesota Wild,MIN,0,CGY,3,6,9,28,14,12,5,10,15,23,12,13
2022-23,12/7/2022,202212070COL,Colorado Avalanche,COL,1,BOS,0,0,0,19,19,13,4,6,10,32,14,8
2022-23,12/7/2022,202212070EDM,Edmonton Oilers,EDM,1,ARI,8,14,22,35,14,8,2,3,5,18,23,12
2022-23,12/7/2022,202212070PHI,Washington Capitals,WSH,0,PHI,4,8,12,27,17,9,1,2,3,27,31,20
2022-23,12/7/2022,202212070SJS,Vancouver Canucks,VAN,0,SJS,6,10,16,26,14,27,5,7,12,35,14,15
2022-23,12/7/2022,202212070VEG,Vegas Golden Knights,VEG,1,NYR,1,2,3,26,22,13,5,10,15,37,31,23
2022-23,12/6/2022,202212060ANA,Anaheim Ducks,ANA,1,CAR,4,8,12,30,22,16,3,5,8,37,12,18
2022-23,12/6/2022,202212060DAL,Dallas Stars,DAL,1,TOR,0,0,0,44,21,10,4,5,9,29,22,27
2022-23,12/6/2022,202212060NJD,Chicago Blackhawks,CHI,0,NJD,0,0,0,24,13,22,3,5,8,29,7,11
2022-23,12/6/2022,202212060NYI,New York Islanders,NYI,1,STL,4,6,10,39,21,10,6,8,14,23,14,17
2022-23,12/6/2022,202212060OTT,Los Angeles Kings,LAK,0,OTT,5,10,15,28,16,20,2,4,6,30,29,14
2022-23,12/6/2022,202212060PIT,Columbus Blue Jackets,CBJ,0,PIT,1,1,2,35,23,8,4,6,10,33,26,24
2022-23,12/6/2022,202212060SEA,Montreal Canadiens,MTL,0,SEA,4,7,11,16,23,19,2,3,5,33,17,17
2022-23,12/6/2022,202212060TBL,Detroit Red Wings,DET,0,TBL,4,7,11,26,31,11,2,4,6,46,24,10
2022-23,12/6/2022,202212060WPG,Florida Panthers,FLA,0,WPG,1,3,4,33,14,8,5,8,13,29,17,11
2022-23,12/6/2022,202212060ANA,Carolina Hurricanes,CAR,0,ANA,3,5,8,37,12,18,4,8,12,30,22,16
2022-23,12/6/2022,202212060DAL,Toronto Maple Leafs,TOR,0,DAL,4,5,9,29,22,27,0,0,0,44,21,10
2022-23,12/6/2022,202212060NJD,New Jersey Devils,NJD,1,CHI,3,5,8,29,7,11,0,0,0,24,13,22
2022-23,12/6/2022,202212060NYI,St. Louis Blues,STL,0,NYI,6,8,14,23,14,17,4,6,10,39,21,10
2022-23,12/6/2022,202212060OTT,Ottawa Senators,OTT,1,LAK,2,4,6,30,29,14,5,10,15,28,16,20
2022-23,12/6/2022,202212060PIT,Pittsburgh Penguins,PIT,1,CBJ,4,6,10,33,26,24,1,1,2,35,23,8
2022-23,12/6/2022,202212060SEA,Seattle Kraken,SEA,1,MTL,2,3,5,33,17,17,4,7,11,16,23,19
2022-23,12/6/2022,202212060TBL,Tampa Bay Lightning,TBL,1,DET,2,4,6,46,24,10,4,7,11,26,31,11
2022-23,12/6/2022,202212060WPG,Winnipeg Jets,WPG,1,FLA,5,8,13,29,17,11,1,3,4,33,14,8
2022-23,12/5/2022,202212050BOS,Boston Bruins,BOS,1,VEG,3,4,7,34,32,13,3,4,7,23,28,13
2022-23,12/5/2022,202212050CGY,Arizona Coyotes,ARI,0,CGY,2,4,6,20,10,14,3,6,9,25,23,9
2022-23,12/5/2022,202212050EDM,Edmonton Oilers,EDM,1,WSH,2,1,3,29,18,14,3,5,8,50,24,14
2022-23,12/5/2022,202212050NYR,New York Rangers,NYR,1,STL,6,7,13,23,24,12,4,6,10,27,20,12
2022-23,12/5/2022,202212050PHI,Colorado Avalanche,COL,0,PHI,3,5,8,24,24,9,4,10,14,29,31,28
2022-23,12/5/2022,202212050VAN,Montreal Canadiens,MTL,0,VAN,6,10,16,26,20,13,7,7,14,27,15,10
2022-23,12/5/2022,202212050BOS,Vegas Golden Knights,VEG,0,BOS,3,4,7,23,28,13,3,4,7,34,32,13
2022-23,12/5/2022,202212050CGY,Calgary Flames,CGY,1,ARI,3,6,9,25,23,9,2,4,6,20,10,14
2022-23,12/5/2022,202212050EDM,Washington Capitals,WSH,0,EDM,3,5,8,50,24,14,2,1,3,29,18,14
2022-23,12/5/2022,202212050NYR,St. Louis Blues,STL,0,NYR,4,6,10,27,20,12,6,7,13,23,24,12
2022-23,12/5/2022,202212050PHI,Philadelphia Flyers,PHI,1,COL,4,10,14,29,31,28,3,5,8,24,24,9
2022-23,12/5/2022,202212050VAN,Vancouver Canucks,VAN,1,MTL,7,7,14,27,15,10,6,10,16,26,20,13
2022-23,12/4/2022,202212040BUF,Buffalo Sabres,BUF,1,SJS,6,9,15,38,8,9,3,6,9,29,16,11
2022-23,12/4/2022,202212040CBJ,Columbus Blue Jackets,CBJ,1,DET,1,4,5,30,13,10,4,8,12,35,13,11
2022-23,12/4/2022,202212040DAL,Dallas Stars,DAL,1,MIN,5,9,14,35,13,11,5,8,13,31,28,21
2022-23,12/4/2022,202212040NYI,Chicago Blackhawks,CHI,0,NYI,0,0,0,21,19,19,3,6,9,40,19,14
2022-23,12/4/2022,202212040WPG,Anaheim Ducks,ANA,0,WPG,2,2,4,29,12,9,4,9,13,37,17,17
2022-23,12/4/2022,202212040BUF,San Jose Sharks,SJS,0,BUF,3,6,9,29,16,11,6,9,15,38,8,9
2022-23,12/4/2022,202212040CBJ,Detroit Red Wings,DET,0,CBJ,4,8,12,35,13,11,1,4,5,30,13,10
2022-23,12/4/2022,202212040DAL,Minnesota Wild,MIN,0,DAL,5,8,13,31,28,21,5,9,14,35,13,11
2022-23,12/4/2022,202212040NYI,New York Islanders,NYI,1,CHI,3,6,9,40,19,14,0,0,0,21,19,19
2022-23,12/4/2022,202212040WPG,Winnipeg Jets,WPG,1,ANA,4,9,13,37,17,17,2,2,4,29,12,9
2022-23,12/3/2022,202212030BOS,Boston Bruins,BOS,1,COL,5,7,12,35,23,12,1,0,1,23,26,13
2022-23,12/3/2022,202212030CGY,Calgary Flames,CGY,1,WSH,5,10,15,35,22,8,2,4,6,29,24,20
2022-23,12/3/2022,202212030DET,Detroit Red Wings,DET,1,VEG,1,2,3,25,19,16,3,6,9,23,20,23
2022-23,12/3/2022,202212030EDM,Edmonton Oilers,EDM,1,MTL,5,9,14,19,28,13,3,5,8,33,32,12
2022-23,12/3/2022,202212030LAK,Carolina Hurricanes,CAR,0,LAK,4,8,12,27,19,17,2,4,6,33,24,7
2022-23,12/3/2022,202212030MIN,Anaheim Ducks,ANA,0,MIN,4,7,11,32,17,17,4,8,12,49,21,9
2022-23,12/3/2022,202212030NYR,Chicago Blackhawks,CHI,0,NYR,5,9,14,21,29,20,2,4,6,26,31,11
2022-23,12/3/2022,202212030OTT,Ottawa Senators,OTT,1,SJS,5,7,12,38,21,10,2,4,6,36,19,14
2022-23,12/3/2022,202212030PHI,New Jersey Devils,NJD,0,PHI,3,4,7,18,32,16,1,4,5,30,28,13
2022-23,12/3/2022,202212030PIT,Pittsburgh Penguins,PIT,1,STL,6,11,17,38,21,12,2,4,6,24,29,15
2022-23,12/3/2022,202212030SEA,Florida Panthers,FLA,0,SEA,4,9,13,25,17,11,1,1,2,36,25,13
2022-23,12/3/2022,202212030TBL,Tampa Bay Lightning,TBL,1,TOR,4,7,11,33,20,11,3,3,6,36,28,10
2022-23,12/3/2022,202212030VAN,Arizona Coyotes,ARI,0,VAN,2,4,6,22,13,17,3,5,8,30,23,6
2022-23,12/3/2022,202212030BOS,Colorado Avalanche,COL,0,BOS,1,0,1,23,26,13,5,7,12,35,23,12
2022-23,12/3/2022,202212030CGY,Washington Capitals,WSH,0,CGY,2,4,6,29,24,20,5,10,15,35,22,8
2022-23,12/3/2022,202212030DET,Vegas Golden Knights,VEG,0,DET,3,6,9,23,20,23,1,2,3,25,19,16
2022-23,12/3/2022,202212030EDM,Montreal Canadiens,MTL,0,EDM,3,5,8,33,32,12,5,9,14,19,28,13
2022-23,12/3/2022,202212030LAK,Los Angeles Kings,LAK,1,CAR,2,4,6,33,24,7,4,8,12,27,19,17
2022-23,12/3/2022,202212030MIN,Minnesota Wild,MIN,1,ANA,4,8,12,49,21,9,4,7,11,32,17,17
2022-23,12/3/2022,202212030NYR,New York Rangers,NYR,1,CHI,2,4,6,26,31,11,5,9,14,21,29,20
2022-23,12/3/2022,202212030OTT,San Jose Sharks,SJS,0,OTT,2,4,6,36,19,14,5,7,12,38,21,10
2022-23,12/3/2022,202212030PHI,Philadelphia Flyers,PHI,1,NJD,1,4,5,30,28,13,3,4,7,18,32,16
2022-23,12/3/2022,202212030PIT,St. Louis Blues,STL,0,PIT,2,4,6,24,29,15,6,11,17,38,21,12
2022-23,12/3/2022,202212030SEA,Seattle Kraken,SEA,1,FLA,1,1,2,36,25,13,4,9,13,25,17,11
2022-23,12/3/2022,202212030TBL,Toronto Maple Leafs,TOR,0,TBL,3,3,6,36,28,10,4,7,11,33,20,11
2022-23,12/3/2022,202212030VAN,Vancouver Canucks,VAN,1,ARI,3,5,8,30,23,6,2,4,6,22,13,17
2022-23,12/2/2022,202212020NYI,Nashville Predators,NSH,0,NYI,4,5,9,23,28,17,1,1,2,47,26,10
2022-23,12/2/2022,202212020NYR,New York Rangers,NYR,1,OTT,1,4,5,26,22,8,3,4,7,36,25,19
2022-23,12/2/2022,202212020WPG,Columbus Blue Jackets,CBJ,0,WPG,4,7,11,25,19,22,1,2,3,36,9,18
2022-23,12/2/2022,202212020NYI,New York Islanders,NYI,1,NSH,1,1,2,47,26,10,4,5,9,23,28,17
2022-23,12/2/2022,202212020NYR,Ottawa Senators,OTT,0,NYR,3,4,7,36,25,19,1,4,5,26,22,8
2022-23,12/2/2022,202212020WPG,Winnipeg Jets,WPG,1,CBJ,1,2,3,36,9,18,4,7,11,25,19,22
2022-23,12/1/2022,202212010BUF,Buffalo Sabres,BUF,1,COL,4,8,12,28,12,3,6,12,18,34,10,18
2022-23,12/1/2022,202212010CGY,Calgary Flames,CGY,1,MTL,1,2,3,41,15,5,2,4,6,19,9,23
2022-23,12/1/2022,202212010DAL,Anaheim Ducks,ANA,0,DAL,0,0,0,27,21,17,5,9,14,41,15,15
2022-23,12/1/2022,202212010LAK,Arizona Coyotes,ARI,0,LAK,3,4,7,18,25,14,5,9,14,31,24,9
2022-23,12/1/2022,202212010MIN,Edmonton Oilers,EDM,0,MIN,3,6,9,21,17,13,5,9,14,30,17,16
2022-23,12/1/2022,202212010NJD,New Jersey Devils,NJD,1,NSH,3,6,9,28,11,17,4,6,10,24,25,13
2022-23,12/1/2022,202212010PHI,Philadelphia Flyers,PHI,1,TBL,1,2,3,20,27,15,4,6,10,27,18,11
2022-23,12/1/2022,202212010PIT,Pittsburgh Penguins,PIT,1,VEG,4,8,12,47,38,9,3,4,7,34,30,28
2022-23,12/1/2022,202212010SEA,Seattle Kraken,SEA,1,WSH,3,5,8,25,26,7,2,4,6,22,20,23
2022-23,12/1/2022,202212010STL,Carolina Hurricanes,CAR,0,STL,6,3,9,36,12,4,4,7,11,21,23,8
2022-23,12/1/2022,202212010VAN,Florida Panthers,FLA,0,VAN,5,6,11,25,9,11,1,1,2,29,20,9
2022-23,12/1/2022,202212010BUF,Colorado Avalanche,COL,0,BUF,6,12,18,34,10,18,4,8,12,28,12,3
2022-23,12/1/2022,202212010CGY,Montreal Canadiens,MTL,0,CGY,2,4,6,19,9,23,1,2,3,41,15,5
2022-23,12/1/2022,202212010DAL,Dallas Stars,DAL,1,ANA,5,9,14,41,15,15,0,0,0,27,21,17
2022-23,12/1/2022,202212010LAK,Los Angeles Kings,LAK,1,ARI,5,9,14,31,24,9,3,4,7,18,25,14
2022-23,12/1/2022,202212010MIN,Minnesota Wild,MIN,1,EDM,5,9,14,30,17,16,3,6,9,21,17,13
2022-23,12/1/2022,202212010NJD,Nashville Predators,NSH,0,NJD,4,6,10,24,25,13,3,6,9,28,11,17
2022-23,12/1/2022,202212010PHI,Tampa Bay Lightning,TBL,0,PHI,4,6,10,27,18,11,1,2,3,20,27,15
2022-23,12/1/2022,202212010PIT,Vegas Golden Knights,VEG,0,PIT,3,4,7,34,30,28,4,8,12,47,38,9
2022-23,12/1/2022,202212010SEA,Washington Capitals,WSH,0,SEA,2,4,6,22,20,23,3,5,8,25,26,7
2022-23,12/1/2022,202212010STL,St. Louis Blues,STL,1,CAR,4,7,11,21,23,8,6,3,9,36,12,4
2022-23,12/1/2022,202212010VAN,Vancouver Canucks,VAN,1,FLA,1,1,2,29,20,9,5,6,11,25,9,11
2022-23,11/30/2022,202211300CHI,Chicago Blackhawks,CHI,1,EDM,4,4,8,24,21,14,5,10,15,41,8,16
2022-23,11/30/2022,202211300DET,Buffalo Sabres,BUF,0,DET,4,5,9,33,8,8,4,7,11,45,25,12
2022-23,11/30/2022,202211300OTT,New York Rangers,NYR,0,OTT,3,5,8,34,28,19,1,1,2,31,30,16
2022-23,11/30/2022,202211300TOR,San Jose Sharks,SJS,0,TOR,1,1,2,21,36,20,3,4,7,31,18,17
2022-23,11/30/2022,202211300CHI,Edmonton Oilers,EDM,0,CHI,5,10,15,41,8,16,4,4,8,24,21,14
2022-23,11/30/2022,202211300DET,Detroit Red Wings,DET,1,BUF,4,7,11,45,25,12,4,5,9,33,8,8
2022-23,11/30/2022,202211300OTT,Ottawa Senators,OTT,1,NYR,1,1,2,31,30,16,3,5,8,34,28,19
2022-23,11/30/2022,202211300TOR,Toronto Maple Leafs,TOR,1,SJS,3,4,7,31,18,17,1,1,2,21,36,20
2022-23,11/29/2022,202211290BOS,Boston Bruins,BOS,1,TBL,3,4,7,21,26,16,1,2,3,28,15,13
2022-23,11/29/2022,202211290CGY,Calgary Flames,CGY,1,FLA,5,10,15,21,12,11,2,4,6,29,12,13
2022-23,11/29/2022,202211290LAK,Los Angeles Kings,LAK,1,SEA,8,14,22,33,41,9,9,13,22,30,31,11
2022-23,11/29/2022,202211290MTL,Montreal Canadiens,MTL,1,SJS,0,0,0,28,11,9,4,7,11,23,11,24
2022-23,11/29/2022,202211290NSH,Anaheim Ducks,ANA,0,NSH,1,2,3,33,12,14,2,4,6,41,21,17
2022-23,11/29/2022,202211290PHI,New York Islanders,NYI,0,PHI,1,2,3,24,30,16,3,2,5,27,30,14
2022-23,11/29/2022,202211290PIT,Carolina Hurricanes,CAR,0,PIT,3,6,9,38,22,15,2,4,6,31,44,13
2022-23,11/29/2022,202211290VAN,Vancouver Canucks,VAN,1,WSH,1,1,2,31,16,11,5,6,11,27,11,12
2022-23,11/29/2022,202211290WPG,Colorado Avalanche,COL,0,WPG,0,0,0,40,19,8,5,10,15,23,17,13
2022-23,11/29/2022,202211290BOS,Tampa Bay Lightning,TBL,0,BOS,1,2,3,28,15,13,3,4,7,21,26,16
2022-23,11/29/2022,202211290CGY,Florida Panthers,FLA,0,CGY,2,4,6,29,12,13,5,10,15,21,12,11
2022-23,11/29/2022,202211290LAK,Seattle Kraken,SEA,0,LAK,9,13,22,30,31,11,8,14,22,33,41,9
2022-23,11/29/2022,202211290MTL,San Jose Sharks,SJS,0,MTL,4,7,11,23,11,24,0,0,0,28,11,9
2022-23,11/29/2022,202211290NSH,Nashville Predators,NSH,1,ANA,2,4,6,41,21,17,1,2,3,33,12,14
2022-23,11/29/2022,202211290PHI,Philadelphia Flyers,PHI,1,NYI,3,2,5,27,30,14,1,2,3,24,30,16
2022-23,11/29/2022,202211290PIT,Pittsburgh Penguins,PIT,1,CAR,2,4,6,31,44,13,3,6,9,38,22,15
2022-23,11/29/2022,202211290VAN,Washington Capitals,WSH,0,VAN,5,6,11,27,11,12,1,1,2,31,16,11
2022-23,11/29/2022,202211290WPG,Winnipeg Jets,WPG,1,COL,5,10,15,23,17,13,0,0,0,40,19,8
2022-23,11/28/2022,202211280BUF,Buffalo Sabres,BUF,1,TBL,5,8,13,36,7,9,6,10,16,25,25,10
2022-23,11/28/2022,202211280CBJ,Columbus Blue Jackets,CBJ,1,VEG,2,4,6,25,12,12,2,3,5,36,16,15
2022-23,11/28/2022,202211280DET,Detroit Red Wings,DET,1,TOR,2,4,6,44,25,5,4,7,11,24,15,21
2022-23,11/28/2022,202211280EDM,Edmonton Oilers,EDM,1,FLA,4,8,12,39,13,7,3,6,9,27,26,14
2022-23,11/28/2022,202211280NYR,New Jersey Devils,NJD,0,NYR,5,6,11,38,12,15,3,6,9,38,24,11
2022-23,11/28/2022,202211280STL,Dallas Stars,DAL,0,STL,4,3,7,24,15,8,1,0,1,18,21,21
2022-23,11/28/2022,202211280BUF,Tampa Bay Lightning,TBL,0,BUF,6,10,16,25,25,10,5,8,13,36,7,9
2022-23,11/28/2022,202211280CBJ,Vegas Golden Knights,VEG,0,CBJ,2,3,5,36,16,15,2,4,6,25,12,12
2022-23,11/28/2022,202211280DET,Toronto Maple Leafs,TOR,0,DET,4,7,11,24,15,21,2,4,6,44,25,5
2022-23,11/28/2022,202211280EDM,Florida Panthers,FLA,0,EDM,3,6,9,27,26,14,4,8,12,39,13,7
2022-23,11/28/2022,202211280NYR,New York Rangers,NYR,1,NJD,3,6,9,38,24,11,5,6,11,38,12,15
2022-23,11/28/2022,202211280STL,St. Louis Blues,STL,1,DAL,1,0,1,18,21,21,4,3,7,24,15,8
2022-23,11/27/2022,202211270ANA,Anaheim Ducks,ANA,1,SEA,3,8,11,27,15,7,5,10,15,25,21,14
2022-23,11/27/2022,202211270CHI,Chicago Blackhawks,CHI,1,WPG,2,4,6,25,25,16,5,13,18,39,16,9
2022-23,11/27/2022,202211270LAK,Los Angeles Kings,LAK,1,OTT,2,4,6,25,29,19,3,6,9,39,33,16
2022-23,11/27/2022,202211270MIN,Arizona Coyotes,ARI,0,MIN,3,5,8,23,10,12,4,7,11,29,22,9
2022-23,11/27/2022,202211270SJS,San Jose Sharks,SJS,1,VAN,3,6,9,34,20,19,4,8,12,19,27,15
2022-23,11/27/2022,202211270ANA,Seattle Kraken,SEA,0,ANA,5,10,15,25,21,14,3,8,11,27,15,7
2022-23,11/27/2022,202211270CHI,Winnipeg Jets,WPG,0,CHI,5,13,18,39,16,9,2,4,6,25,25,16
2022-23,11/27/2022,202211270LAK,Ottawa Senators,OTT,0,LAK,3,6,9,39,33,16,2,4,6,25,29,19
2022-23,11/27/2022,202211270MIN,Minnesota Wild,MIN,1,ARI,4,7,11,29,22,9,3,5,8,23,10,12
2022-23,11/27/2022,202211270SJS,Vancouver Canucks,VAN,0,SJS,4,8,12,19,27,15,3,6,9,34,20,19
2022-23,11/26/2022,202211260CAR,Carolina Hurricanes,CAR,1,CGY,3,4,7,27,21,10,2,3,5,18,28,10
2022-23,11/26/2022,202211260COL,Colorado Avalanche,COL,1,DAL,4,5,9,35,32,12,1,2,3,42,33,10
2022-23,11/26/2022,202211260FLA,Florida Panthers,FLA,1,STL,4,5,9,31,15,12,5,9,14,34,20,7
2022-23,11/26/2022,202211260NJD,New Jersey Devils,NJD,1,WSH,5,7,12,29,11,26,1,2,3,37,10,4
2022-23,11/26/2022,202211260NYI,New York Islanders,NYI,1,PHI,5,5,10,22,26,9,1,3,4,25,21,10
2022-23,11/26/2022,202211260NYR,Edmonton Oilers,EDM,0,NYR,4,7,11,32,13,9,3,6,9,22,21,11
2022-23,11/26/2022,202211260PIT,Pittsburgh Penguins,PIT,1,TOR,1,2,3,24,51,13,4,7,11,38,21,12
2022-23,11/26/2022,202211260VEG,Vancouver Canucks,VAN,0,VEG,5,10,15,34,32,16,1,2,3,25,41,17
2022-23,11/26/2022,202211260CAR,Calgary Flames,CGY,0,CAR,2,3,5,18,28,10,3,4,7,27,21,10
2022-23,11/26/2022,202211260COL,Dallas Stars,DAL,0,COL,1,2,3,42,33,10,4,5,9,35,32,12
2022-23,11/26/2022,202211260FLA,St. Louis Blues,STL,0,FLA,5,9,14,34,20,7,4,5,9,31,15,12
2022-23,11/26/2022,202211260NJD,Washington Capitals,WSH,0,NJD,1,2,3,37,10,4,5,7,12,29,11,26
2022-23,11/26/2022,202211260NYI,Philadelphia Flyers,PHI,0,NYI,1,3,4,25,21,10,5,5,10,22,26,9
2022-23,11/26/2022,202211260NYR,New York Rangers,NYR,1,EDM,3,6,9,22,21,11,4,7,11,32,13,9
2022-23,11/26/2022,202211260PIT,Toronto Maple Leafs,TOR,0,PIT,4,7,11,38,21,12,1,2,3,24,51,13
2022-23,11/26/2022,202211260VEG,Vegas Golden Knights,VEG,1,VAN,1,2,3,25,41,17,5,10,15,34,32,16
2022-23,11/25/2022,202211250ANA,Anaheim Ducks,ANA,1,OTT,1,0,1,31,13,16,4,8,12,32,10,16
2022-23,11/25/2022,202211250BOS,Boston Bruins,BOS,1,CAR,1,5,6,32,18,2,2,4,6,33,25,14
2022-23,11/25/2022,202211250BUF,Buffalo Sabres,BUF,1,NJD,1,2,3,33,23,18,3,5,8,44,15,15
2022-23,11/25/2022,202211250CBJ,Columbus Blue Jackets,CBJ,1,NYI,2,3,5,25,23,19,3,4,7,23,22,14
2022-23,11/25/2022,202211250CHI,Chicago Blackhawks,CHI,1,MTL,2,3,5,29,23,12,2,3,5,23,13,15
2022-23,11/25/2022,202211250DAL,Dallas Stars,DAL,1,WPG,4,8,12,41,24,14,5,10,15,27,23,14
2022-23,11/25/2022,202211250DET,Arizona Coyotes,ARI,0,DET,3,4,7,21,21,11,3,6,9,36,17,9
2022-23,11/25/2022,202211250MIN,Minnesota Wild,MIN,1,TOR,3,6,9,28,22,10,4,7,11,25,12,19
2022-23,11/25/2022,202211250PHI,Philadelphia Flyers,PHI,1,PIT,1,2,3,23,34,18,3,6,9,27,23,10
2022-23,11/25/2022,202211250SJS,Los Angeles Kings,LAK,0,SJS,5,9,14,29,22,21,2,2,4,30,26,15
2022-23,11/25/2022,202211250TBL,St. Louis Blues,STL,0,TBL,2,4,6,27,29,10,5,10,15,27,36,16
2022-23,11/25/2022,202211250VEG,Seattle Kraken,SEA,0,VEG,4,7,11,28,29,15,1,3,4,18,28,24
2022-23,11/25/2022,202211250WSH,Calgary Flames,CGY,0,WSH,0,0,0,31,26,17,3,6,9,21,34,14
2022-23,11/25/2022,202211250ANA,Ottawa Senators,OTT,0,ANA,4,8,12,32,10,16,1,0,1,31,13,16
2022-23,11/25/2022,202211250BOS,Carolina Hurricanes,CAR,0,BOS,2,4,6,33,25,14,1,5,6,32,18,2
2022-23,11/25/2022,202211250BUF,New Jersey Devils,NJD,0,BUF,3,5,8,44,15,15,1,2,3,33,23,18
2022-23,11/25/2022,202211250CBJ,New York Islanders,NYI,0,CBJ,3,4,7,23,22,14,2,3,5,25,23,19
2022-23,11/25/2022,202211250CHI,Montreal Canadiens,MTL,0,CHI,2,3,5,23,13,15,2,3,5,29,23,12
2022-23,11/25/2022,202211250DAL,Winnipeg Jets,WPG,0,DAL,5,10,15,27,23,14,4,8,12,41,24,14
2022-23,11/25/2022,202211250DET,Detroit Red Wings,DET,1,ARI,3,6,9,36,17,9,3,4,7,21,21,11
2022-23,11/25/2022,202211250MIN,Toronto Maple Leafs,TOR,0,MIN,4,7,11,25,12,19,3,6,9,28,22,10
2022-23,11/25/2022,202211250PHI,Pittsburgh Penguins,PIT,0,PHI,3,6,9,27,23,10,1,2,3,23,34,18
2022-23,11/25/2022,202211250SJS,San Jose Sharks,SJS,1,LAK,2,2,4,30,26,15,5,9,14,29,22,21
2022-23,11/25/2022,202211250TBL,Tampa Bay Lightning,TBL,1,STL,5,10,15,27,36,16,2,4,6,27,29,10
2022-23,11/25/2022,202211250VEG,Vegas Golden Knights,VEG,1,SEA,1,3,4,18,28,24,4,7,11,28,29,15
2022-23,11/25/2022,202211250WSH,Washington Capitals,WSH,1,CGY,3,6,9,21,34,14,0,0,0,31,26,17
2022-23,11/23/2022,202211230ANA,Anaheim Ducks,ANA,1,NYR,3,5,8,21,18,18,2,2,4,43,21,10
2022-23,11/23/2022,202211230BUF,Buffalo Sabres,BUF,1,STL,6,6,12,32,15,12,2,4,6,36,26,12
2022-23,11/23/2022,202211230CAR,Arizona Coyotes,ARI,0,CAR,4,7,11,26,19,24,0,0,0,35,20,11
2022-23,11/23/2022,202211230CBJ,Columbus Blue Jackets,CBJ,1,MTL,1,0,1,29,12,10,3,4,7,29,13,21
2022-23,11/23/2022,202211230COL,Colorado Avalanche,COL,1,VAN,3,6,9,34,12,9,3,7,10,22,12,17
2022-23,11/23/2022,202211230DAL,Chicago Blackhawks,CHI,0,DAL,4,7,11,30,13,28,6,9,15,39,23,13
2022-23,11/23/2022,202211230DET,Detroit Red Wings,DET,1,NSH,3,4,7,29,29,23,0,0,0,26,18,9
2022-23,11/23/2022,202211230FLA,Boston Bruins,BOS,0,FLA,2,2,4,34,20,9,5,8,13,29,27,18
2022-23,11/23/2022,202211230MIN,Minnesota Wild,MIN,1,WPG,6,11,17,39,27,18,1,2,3,29,13,11
2022-23,11/23/2022,202211230NJD,New Jersey Devils,NJD,1,TOR,1,2,3,35,15,11,2,2,4,20,8,18
2022-23,11/23/2022,202211230NYI,Edmonton Oilers,EDM,0,NYI,0,0,0,46,12,7,3,6,9,29,20,13
2022-23,11/23/2022,202211230PIT,Calgary Flames,CGY,0,PIT,1,2,3,34,41,21,1,2,3,38,35,13
2022-23,11/23/2022,202211230SEA,Seattle Kraken,SEA,1,SJS,8,13,21,27,17,15,5,8,13,26,19,18
2022-23,11/23/2022,202211230VEG,Ottawa Senators,OTT,0,VEG,1,2,3,35,43,11,4,6,10,36,19,23
2022-23,11/23/2022,202211230WSH,Philadelphia Flyers,PHI,0,WSH,2,4,6,15,28,14,3,6,9,32,28,15
2022-23,11/23/2022,202211230ANA,New York Rangers,NYR,0,ANA,2,2,4,43,21,10,3,5,8,21,18,18
2022-23,11/23/2022,202211230BUF,St. Louis Blues,STL,0,BUF,2,4,6,36,26,12,6,6,12,32,15,12
2022-23,11/23/2022,202211230CAR,Carolina Hurricanes,CAR,1,ARI,0,0,0,35,20,11,4,7,11,26,19,24
2022-23,11/23/2022,202211230CBJ,Montreal Canadiens,MTL,0,CBJ,3,4,7,29,13,21,1,0,1,29,12,10
2022-23,11/23/2022,202211230COL,Vancouver Canucks,VAN,0,COL,3,7,10,22,12,17,3,6,9,34,12,9
2022-23,11/23/2022,202211230DAL,Dallas Stars,DAL,1,CHI,6,9,15,39,23,13,4,7,11,30,13,28
2022-23,11/23/2022,202211230DET,Nashville Predators,NSH,0,DET,0,0,0,26,18,9,3,4,7,29,29,23
2022-23,11/23/2022,202211230FLA,Florida Panthers,FLA,1,BOS,5,8,13,29,27,18,2,2,4,34,20,9
2022-23,11/23/2022,202211230MIN,Winnipeg Jets,WPG,0,MIN,1,2,3,29,13,11,6,11,17,39,27,18
2022-23,11/23/2022,202211230NJD,Toronto Maple Leafs,TOR,0,NJD,2,2,4,20,8,18,1,2,3,35,15,11
2022-23,11/23/2022,202211230NYI,New York Islanders,NYI,1,EDM,3,6,9,29,20,13,0,0,0,46,12,7
2022-23,11/23/2022,202211230PIT,Pittsburgh Penguins,PIT,1,CGY,1,2,3,38,35,13,1,2,3,34,41,21
2022-23,11/23/2022,202211230SEA,San Jose Sharks,SJS,0,SEA,5,8,13,26,19,18,8,13,21,27,17,15
2022-23,11/23/2022,202211230VEG,Vegas Golden Knights,VEG,1,OTT,4,6,10,36,19,23,1,2,3,35,43,11
2022-23,11/23/2022,202211230WSH,Washington Capitals,WSH,1,PHI,3,6,9,32,28,15,2,4,6,15,28,14
2022-23,11/22/2022,202211220LAK,Los Angeles Kings,LAK,1,NYR,3,6,9,36,22,15,5,10,15,25,41,14
2022-23,11/22/2022,202211220MTL,Buffalo Sabres,BUF,0,MTL,7,14,21,38,15,9,2,3,5,30,19,18
2022-23,11/22/2022,202211220LAK,New York Rangers,NYR,0,LAK,5,10,15,25,41,14,3,6,9,36,22,15
2022-23,11/22/2022,202211220MTL,Montreal Canadiens,MTL,1,BUF,2,3,5,30,19,18,7,14,21,38,15,9
2022-23,11/21/2022,202211210DAL,Colorado Avalanche,COL,0,DAL,2,4,6,35,16,20,2,3,5,24,17,17
2022-23,11/21/2022,202211210NJD,Edmonton Oilers,EDM,0,NJD,2,4,6,28,16,11,5,8,13,28,20,11
2022-23,11/21/2022,202211210NSH,Arizona Coyotes,ARI,0,NSH,3,3,6,26,28,13,3,5,8,45,24,9
2022-23,11/21/2022,202211210PHI,Calgary Flames,CGY,0,PHI,5,7,12,30,24,20,1,2,3,21,25,12
2022-23,11/21/2022,202211210SJS,Ottawa Senators,OTT,0,SJS,1,1,2,33,23,15,5,9,14,31,17,16
2022-23,11/21/2022,202211210STL,Anaheim Ducks,ANA,0,STL,1,1,2,28,11,13,3,4,7,25,22,12
2022-23,11/21/2022,202211210TBL,Boston Bruins,BOS,0,TBL,4,8,12,23,23,4,2,5,7,32,43,10
2022-23,11/21/2022,202211210TOR,New York Islanders,NYI,0,TOR,2,4,6,23,50,12,2,4,6,30,15,7
2022-23,11/21/2022,202211210VAN,Vancouver Canucks,VAN,1,VEG,4,7,11,28,21,11,5,9,14,38,14,15
2022-23,11/21/2022,202211210WPG,Carolina Hurricanes,CAR,0,WPG,3,6,9,26,18,7,4,7,11,23,15,18
2022-23,11/21/2022,202211210DAL,Dallas Stars,DAL,1,COL,2,3,5,24,17,17,2,4,6,35,16,20
2022-23,11/21/2022,202211210NJD,New Jersey Devils,NJD,1,EDM,5,8,13,28,20,11,2,4,6,28,16,11
2022-23,11/21/2022,202211210NSH,Nashville Predators,NSH,1,ARI,3,5,8,45,24,9,3,3,6,26,28,13
2022-23,11/21/2022,202211210PHI,Philadelphia Flyers,PHI,1,CGY,1,2,3,21,25,12,5,7,12,30,24,20
2022-23,11/21/2022,202211210SJS,San Jose Sharks,SJS,1,OTT,5,9,14,31,17,16,1,1,2,33,23,15
2022-23,11/21/2022,202211210STL,St. Louis Blues,STL,1,ANA,3,4,7,25,22,12,1,1,2,28,11,13
2022-23,11/21/2022,202211210TBL,Tampa Bay Lightning,TBL,1,BOS,2,5,7,32,43,10,4,8,12,23,23,4
2022-23,11/21/2022,202211210TOR,Toronto Maple Leafs,TOR,1,NYI,2,4,6,30,15,7,2,4,6,23,50,12
2022-23,11/21/2022,202211210VAN,Vegas Golden Knights,VEG,0,VAN,5,9,14,38,14,15,4,7,11,28,21,11
2022-23,11/21/2022,202211210WPG,Winnipeg Jets,WPG,1,CAR,4,7,11,23,15,18,3,6,9,26,18,7
2022-23,11/20/2022,202211200CBJ,Columbus Blue Jackets,CBJ,1,FLA,5,6,11,21,32,26,3,5,8,46,15,4
2022-23,11/20/2022,202211200CHI,Chicago Blackhawks,CHI,1,PIT,3,2,5,32,23,15,5,10,15,25,13,14
2022-23,11/20/2022,202211200CBJ,Florida Panthers,FLA,0,CBJ,3,5,8,46,15,4,5,6,11,21,32,26
2022-23,11/20/2022,202211200CHI,Pittsburgh Penguins,PIT,0,CHI,5,10,15,25,13,14,3,2,5,32,23,15
2022-23,11/19/2022,202211190BOS,Boston Bruins,BOS,1,CHI,4,11,15,39,14,5,0,2,2,17,23,9
2022-23,11/19/2022,202211190CBJ,Columbus Blue Jackets,CBJ,1,DET,1,2,3,26,20,12,6,10,16,37,11,13
2022-23,11/19/2022,202211190DAL,Dallas Stars,DAL,1,NYI,5,8,13,33,15,16,2,4,6,28,17,14
2022-23,11/19/2022,202211190EDM,Edmonton Oilers,EDM,1,VEG,4,7,11,23,28,16,3,4,7,32,20,13
2022-23,11/19/2022,202211190FLA,Calgary Flames,CGY,0,FLA,4,6,10,34,32,16,4,6,10,35,17,12
2022-23,11/19/2022,202211190MIN,Carolina Hurricanes,CAR,0,MIN,1,2,3,20,20,13,2,4,6,21,23,19
2022-23,11/19/2022,202211190MTL,Montreal Canadiens,MTL,1,PHI,4,8,12,32,16,17,4,6,10,26,29,17
2022-23,11/19/2022,202211190NSH,Nashville Predators,NSH,1,TBL,2,3,5,32,35,22,3,6,9,39,20,10
2022-23,11/19/2022,202211190OTT,New Jersey Devils,NJD,0,OTT,5,7,12,36,23,11,0,2,2,19,30,10
2022-23,11/19/2022,202211190SEA,Los Angeles Kings,LAK,0,SEA,2,3,5,29,25,8,3,5,8,29,24,23
2022-23,11/19/2022,202211190SJS,New York Rangers,NYR,0,SJS,2,4,6,43,32,8,1,2,3,22,17,16
2022-23,11/19/2022,202211190STL,Anaheim Ducks,ANA,0,STL,2,3,5,30,13,9,6,9,15,34,17,18
2022-23,11/19/2022,202211190TOR,Buffalo Sabres,BUF,0,TOR,2,4,6,30,24,9,5,9,14,19,26,14
2022-23,11/19/2022,202211190WPG,Pittsburgh Penguins,PIT,0,WPG,3,5,8,30,19,6,0,0,0,29,20,9
2022-23,11/19/2022,202211190WSH,Colorado Avalanche,COL,0,WSH,4,6,10,27,22,18,0,0,0,30,22,16
2022-23,11/19/2022,202211190BOS,Chicago Blackhawks,CHI,0,BOS,0,2,2,17,23,9,4,11,15,39,14,5
2022-23,11/19/2022,202211190CBJ,Detroit Red Wings,DET,0,CBJ,6,10,16,37,11,13,1,2,3,26,20,12
2022-23,11/19/2022,202211190DAL,New York Islanders,NYI,0,DAL,2,4,6,28,17,14,5,8,13,33,15,16
2022-23,11/19/2022,202211190EDM,Vegas Golden Knights,VEG,0,EDM,3,4,7,32,20,13,4,7,11,23,28,16
2022-23,11/19/2022,202211190FLA,Florida Panthers,FLA,1,CGY,4,6,10,35,17,12,4,6,10,34,32,16
2022-23,11/19/2022,202211190MIN,Minnesota Wild,MIN,1,CAR,2,4,6,21,23,19,1,2,3,20,20,13
2022-23,11/19/2022,202211190MTL,Philadelphia Flyers,PHI,0,MTL,4,6,10,26,29,17,4,8,12,32,16,17
2022-23,11/19/2022,202211190NSH,Tampa Bay Lightning,TBL,0,NSH,3,6,9,39,20,10,2,3,5,32,35,22
2022-23,11/19/2022,202211190OTT,Ottawa Senators,OTT,1,NJD,0,2,2,19,30,10,5,7,12,36,23,11
2022-23,11/19/2022,202211190SEA,Seattle Kraken,SEA,1,LAK,3,5,8,29,24,23,2,3,5,29,25,8
2022-23,11/19/2022,202211190SJS,San Jose Sharks,SJS,1,NYR,1,2,3,22,17,16,2,4,6,43,32,8
2022-23,11/19/2022,202211190STL,St. Louis Blues,STL,1,ANA,6,9,15,34,17,18,2,3,5,30,13,9
2022-23,11/19/2022,202211190TOR,Toronto Maple Leafs,TOR,1,BUF,5,9,14,19,26,14,2,4,6,30,24,9
2022-23,11/19/2022,202211190WPG,Winnipeg Jets,WPG,1,PIT,0,0,0,29,20,9,3,5,8,30,19,6
2022-23,11/19/2022,202211190WSH,Washington Capitals,WSH,1,COL,0,0,0,30,22,16,4,6,10,27,22,18
2022-23,11/18/2022,202211180VAN,Los Angeles Kings,LAK,0,VAN,1,1,2,37,12,16,4,6,10,21,28,10
2022-23,11/18/2022,202211180VAN,Vancouver Canucks,VAN,1,LAK,4,6,10,21,28,10,1,1,2,37,12,16
2022-23,11/17/2022,202211170BOS,Boston Bruins,BOS,1,PHI,2,8,10,27,19,9,1,2,3,21,20,19
2022-23,11/17/2022,202211170CAR,Carolina Hurricanes,CAR,1,COL,2,2,4,46,17,8,3,4,7,14,26,14
2022-23,11/17/2022,202211170CBJ,Columbus Blue Jackets,CBJ,1,MTL,6,9,15,26,18,15,4,8,12,42,8,15
2022-23,11/17/2022,202211170FLA,Dallas Stars,DAL,0,FLA,6,10,16,28,13,16,4,8,12,42,29,15
2022-23,11/17/2022,202211170MIN,Minnesota Wild,MIN,1,PIT,4,5,9,23,29,16,6,10,16,28,23,12
2022-23,11/17/2022,202211170NSH,Nashville Predators,NSH,1,NYI,5,10,15,31,18,22,4,7,11,33,37,8
2022-23,11/17/2022,202211170SEA,New York Rangers,NYR,0,SEA,2,4,6,29,23,7,3,6,9,32,22,14
2022-23,11/17/2022,202211170SJS,Detroit Red Wings,DET,0,SJS,7,11,18,21,24,19,4,7,11,25,14,13
2022-23,11/17/2022,202211170STL,St. Louis Blues,STL,1,WSH,4,7,11,21,14,15,4,7,11,51,16,9
2022-23,11/17/2022,202211170TBL,Calgary Flames,CGY,0,TBL,1,2,3,37,43,13,4,6,10,24,34,19
2022-23,11/17/2022,202211170TOR,New Jersey Devils,NJD,0,TOR,3,4,7,33,30,17,2,4,6,24,21,11
2022-23,11/17/2022,202211170VEG,Arizona Coyotes,ARI,0,VEG,1,1,2,25,24,8,4,7,11,36,25,17
2022-23,11/17/2022,202211170WPG,Anaheim Ducks,ANA,0,WPG,2,4,6,27,9,16,3,6,9,30,12,9
2022-23,11/17/2022,202211170BOS,Philadelphia Flyers,PHI,0,BOS,1,2,3,21,20,19,2,8,10,27,19,9
2022-23,11/17/2022,202211170CAR,Colorado Avalanche,COL,0,CAR,3,4,7,14,26,14,2,2,4,46,17,8
2022-23,11/17/2022,202211170CBJ,Montreal Canadiens,MTL,0,CBJ,4,8,12,42,8,15,6,9,15,26,18,15
2022-23,11/17/2022,202211170FLA,Florida Panthers,FLA,1,DAL,4,8,12,42,29,15,6,10,16,28,13,16
2022-23,11/17/2022,202211170MIN,Pittsburgh Penguins,PIT,0,MIN,6,10,16,28,23,12,4,5,9,23,29,16
2022-23,11/17/2022,202211170NSH,New York Islanders,NYI,0,NSH,4,7,11,33,37,8,5,10,15,31,18,22
2022-23,11/17/2022,202211170SEA,Seattle Kraken,SEA,1,NYR,3,6,9,32,22,14,2,4,6,29,23,7
2022-23,11/17/2022,202211170SJS,San Jose Sharks,SJS,1,DET,4,7,11,25,14,13,7,11,18,21,24,19
2022-23,11/17/2022,202211170STL,Washington Capitals,WSH,0,STL,4,7,11,51,16,9,4,7,11,21,14,15
2022-23,11/17/2022,202211170TBL,Tampa Bay Lightning,TBL,1,CGY,4,6,10,24,34,19,1,2,3,37,43,13
2022-23,11/17/2022,202211170TOR,Toronto Maple Leafs,TOR,1,NJD,2,4,6,24,21,11,3,4,7,33,30,17
2022-23,11/17/2022,202211170VEG,Vegas Golden Knights,VEG,1,ARI,4,7,11,36,25,17,1,1,2,25,24,8
2022-23,11/17/2022,202211170WPG,Winnipeg Jets,WPG,1,ANA,3,6,9,30,12,9,2,4,6,27,9,16
2022-23,11/16/2022,202211160CHI,Chicago Blackhawks,CHI,1,STL,2,4,6,26,10,8,5,7,12,34,10,18
2022-23,11/16/2022,202211160EDM,Edmonton Oilers,EDM,1,LAK,1,0,1,23,38,6,3,5,8,31,27,28
2022-23,11/16/2022,202211160OTT,Buffalo Sabres,BUF,0,OTT,1,2,3,28,9,9,4,6,10,32,20,16
2022-23,11/16/2022,202211160CHI,St. Louis Blues,STL,0,CHI,5,7,12,34,10,18,2,4,6,26,10,8
2022-23,11/16/2022,202211160EDM,Los Angeles Kings,LAK,0,EDM,3,5,8,31,27,28,1,0,1,23,38,6
2022-23,11/16/2022,202211160OTT,Ottawa Senators,OTT,1,BUF,4,6,10,32,20,16,1,2,3,28,9,9
2022-23,11/15/2022,202211150ANA,Anaheim Ducks,ANA,1,DET,3,5,8,29,17,13,2,4,6,33,19,25
2022-23,11/15/2022,202211150BUF,Buffalo Sabres,BUF,1,VAN,4,8,12,30,5,12,5,8,13,32,11,17
2022-23,11/15/2022,202211150CBJ,Columbus Blue Jackets,CBJ,1,PHI,5,7,12,32,32,22,4,8,12,34,24,15
2022-23,11/15/2022,202211150FLA,Florida Panthers,FLA,1,WSH,5,8,13,39,21,14,2,4,6,40,20,16
2022-23,11/15/2022,202211150MTL,Montreal Canadiens,MTL,1,NJD,1,2,3,26,25,22,5,5,10,39,10,21
2022-23,11/15/2022,202211150NSH,Minnesota Wild,MIN,0,NSH,1,2,3,33,22,10,2,4,6,25,43,19
2022-23,11/15/2022,202211150PIT,Pittsburgh Penguins,PIT,1,TOR,2,2,4,35,44,15,5,9,14,26,16,21
2022-23,11/15/2022,202211150TBL,Dallas Stars,DAL,0,TBL,4,6,10,31,39,16,5,10,15,38,36,10
2022-23,11/15/2022,202211150VEG,San Jose Sharks,SJS,0,VEG,5,8,13,28,31,10,2,3,5,26,27,22
2022-23,11/15/2022,202211150ANA,Detroit Red Wings,DET,0,ANA,2,4,6,33,19,25,3,5,8,29,17,13
2022-23,11/15/2022,202211150BUF,Vancouver Canucks,VAN,0,BUF,5,8,13,32,11,17,4,8,12,30,5,12
2022-23,11/15/2022,202211150CBJ,Philadelphia Flyers,PHI,0,CBJ,4,8,12,34,24,15,5,7,12,32,32,22
2022-23,11/15/2022,202211150FLA,Washington Capitals,WSH,0,FLA,2,4,6,40,20,16,5,8,13,39,21,14
2022-23,11/15/2022,202211150MTL,New Jersey Devils,NJD,0,MTL,5,5,10,39,10,21,1,2,3,26,25,22
2022-23,11/15/2022,202211150NSH,Nashville Predators,NSH,1,MIN,2,4,6,25,43,19,1,2,3,33,22,10
2022-23,11/15/2022,202211150PIT,Toronto Maple Leafs,TOR,0,PIT,5,9,14,26,16,21,2,2,4,35,44,15
2022-23,11/15/2022,202211150TBL,Tampa Bay Lightning,TBL,1,DAL,5,10,15,38,36,10,4,6,10,31,39,16
2022-23,11/15/2022,202211150VEG,Vegas Golden Knights,VEG,1,SJS,2,3,5,26,27,22,5,8,13,28,31,10
2022-23,11/14/2022,202211140CGY,Calgary Flames,CGY,1,LAK,5,11,16,27,19,12,5,9,14,28,23,15
2022-23,11/14/2022,202211140CHI,Carolina Hurricanes,CAR,0,CHI,3,5,8,27,6,7,0,0,0,22,11,11
2022-23,11/14/2022,202211140COL,Colorado Avalanche,COL,1,STL,2,4,6,43,15,6,3,6,9,37,15,15
2022-23,11/14/2022,202211140OTT,New York Islanders,NYI,0,OTT,4,6,10,35,26,20,2,4,6,34,13,10
2022-23,11/14/2022,202211140CGY,Los Angeles Kings,LAK,0,CGY,5,9,14,28,23,15,5,11,16,27,19,12
2022-23,11/14/2022,202211140CHI,Chicago Blackhawks,CHI,1,CAR,0,0,0,22,11,11,3,5,8,27,6,7
2022-23,11/14/2022,202211140COL,St. Louis Blues,STL,0,COL,3,6,9,37,15,15,2,4,6,43,15,6
2022-23,11/14/2022,202211140OTT,Ottawa Senators,OTT,1,NYI,2,4,6,34,13,10,4,6,10,35,26,20
2022-23,11/13/2022,202211130BOS,Boston Bruins,BOS,1,VAN,4,10,14,30,15,10,1,2,3,28,16,15
2022-23,11/13/2022,202211130MIN,Minnesota Wild,MIN,1,SJS,2,3,5,30,21,14,2,4,6,36,11,12
2022-23,11/13/2022,202211130NYR,Arizona Coyotes,ARI,0,NYR,1,1,2,27,16,13,4,6,10,27,30,16
2022-23,11/13/2022,202211130PHI,Dallas Stars,DAL,0,PHI,4,10,14,30,27,18,1,2,3,35,24,7
2022-23,11/13/2022,202211130SEA,Seattle Kraken,SEA,1,WPG,2,4,6,21,19,22,3,5,8,30,19,11
2022-23,11/13/2022,202211130TBL,Tampa Bay Lightning,TBL,1,WSH,6,11,17,35,39,10,3,4,7,22,35,14
2022-23,11/13/2022,202211130BOS,Vancouver Canucks,VAN,0,BOS,1,2,3,28,16,15,4,10,14,30,15,10
2022-23,11/13/2022,202211130MIN,San Jose Sharks,SJS,0,MIN,2,4,6,36,11,12,2,3,5,30,21,14
2022-23,11/13/2022,202211130NYR,New York Rangers,NYR,1,ARI,4,6,10,27,30,16,1,1,2,27,16,13
2022-23,11/13/2022,202211130PHI,Philadelphia Flyers,PHI,1,DAL,1,2,3,35,24,7,4,10,14,30,27,18
2022-23,11/13/2022,202211130SEA,Winnipeg Jets,WPG,0,SEA,3,5,8,30,19,11,2,4,6,21,19,22
2022-23,11/13/2022,202211130TBL,Washington Capitals,WSH,0,TBL,3,4,7,22,35,14,6,11,17,35,39,10
2022-23,11/12/2022,202211120ANA,Anaheim Ducks,ANA,1,CHI,2,3,5,39,14,6,3,4,7,22,30,15
2022-23,11/12/2022,202211120BUF,Boston Bruins,BOS,0,BUF,0,5,5,24,13,11,1,0,1,29,8,11
2022-23,11/12/2022,202211120CGY,Calgary Flames,CGY,1,WPG,3,6,9,35,23,18,2,3,5,23,14,15
2022-23,11/12/2022,202211120COL,Carolina Hurricanes,CAR,0,COL,1,2,3,24,11,5,4,6,10,26,13,17
2022-23,11/12/2022,202211120FLA,Edmonton Oilers,EDM,0,FLA,4,5,9,32,13,13,2,3,5,40,14,8
2022-23,11/12/2022,202211120LAK,Detroit Red Wings,DET,0,LAK,3,6,9,21,35,22,4,7,11,21,19,18
2022-23,11/12/2022,202211120MTL,Montreal Canadiens,MTL,1,PIT,5,6,11,42,15,8,4,8,12,23,20,21
2022-23,11/12/2022,202211120NJD,Arizona Coyotes,ARI,0,NJD,2,4,6,15,13,7,4,7,11,26,12,6
2022-23,11/12/2022,202211120NSH,Nashville Predators,NSH,1,NYR,2,3,5,18,25,22,1,2,3,35,31,16
2022-23,11/12/2022,202211120NYI,Columbus Blue Jackets,CBJ,0,NYI,2,6,8,26,13,17,4,8,12,43,15,17
2022-23,11/12/2022,202211120PHI,Ottawa Senators,OTT,0,PHI,4,7,11,25,34,12,1,2,3,30,45,12
2022-23,11/12/2022,202211120TOR,Toronto Maple Leafs,TOR,1,VAN,2,6,8,29,25,18,2,4,6,29,35,13
2022-23,11/12/2022,202211120VEG,St. Louis Blues,STL,0,VEG,3,4,7,26,29,23,1,3,4,34,32,20
2022-23,11/12/2022,202211120ANA,Chicago Blackhawks,CHI,0,ANA,3,4,7,22,30,15,2,3,5,39,14,6
2022-23,11/12/2022,202211120BUF,Buffalo Sabres,BUF,1,BOS,1,0,1,29,8,11,0,5,5,24,13,11
2022-23,11/12/2022,202211120CGY,Winnipeg Jets,WPG,0,CGY,2,3,5,23,14,15,3,6,9,35,23,18
2022-23,11/12/2022,202211120COL,Colorado Avalanche,COL,1,CAR,4,6,10,26,13,17,1,2,3,24,11,5
2022-23,11/12/2022,202211120FLA,Florida Panthers,FLA,1,EDM,2,3,5,40,14,8,4,5,9,32,13,13
2022-23,11/12/2022,202211120LAK,Los Angeles Kings,LAK,1,DET,4,7,11,21,19,18,3,6,9,21,35,22
2022-23,11/12/2022,202211120MTL,Pittsburgh Penguins,PIT,0,MTL,4,8,12,23,20,21,5,6,11,42,15,8
2022-23,11/12/2022,202211120NJD,New Jersey Devils,NJD,1,ARI,4,7,11,26,12,6,2,4,6,15,13,7
2022-23,11/12/2022,202211120NSH,New York Rangers,NYR,0,NSH,1,2,3,35,31,16,2,3,5,18,25,22
2022-23,11/12/2022,202211120NYI,New York Islanders,NYI,1,CBJ,4,8,12,43,15,17,2,6,8,26,13,17
2022-23,11/12/2022,202211120PHI,Philadelphia Flyers,PHI,1,OTT,1,2,3,30,45,12,4,7,11,25,34,12
2022-23,11/12/2022,202211120TOR,Vancouver Canucks,VAN,0,TOR,2,4,6,29,35,13,2,6,8,29,25,18
2022-23,11/12/2022,202211120VEG,Vegas Golden Knights,VEG,1,STL,1,3,4,34,32,20,3,4,7,26,29,23
2022-23,11/11/2022,202211110DAL,Dallas Stars,DAL,1,SJS,4,5,9,27,16,6,4,8,12,16,21,21
2022-23,11/11/2022,202211110SEA,Minnesota Wild,MIN,0,SEA,1,2,3,21,17,21,0,0,0,28,29,5
2022-23,11/11/2022,202211110TOR,Pittsburgh Penguins,PIT,0,TOR,4,5,9,22,38,18,2,3,5,29,13,13
2022-23,11/11/2022,202211110WSH,Tampa Bay Lightning,TBL,0,WSH,1,2,3,29,15,25,5,8,13,22,11,22
2022-23,11/11/2022,202211110DAL,San Jose Sharks,SJS,0,DAL,4,8,12,16,21,21,4,5,9,27,16,6
2022-23,11/11/2022,202211110SEA,Seattle Kraken,SEA,1,MIN,0,0,0,28,29,5,1,2,3,21,17,21
2022-23,11/11/2022,202211110TOR,Toronto Maple Leafs,TOR,1,PIT,2,3,5,29,13,13,4,5,9,22,38,18
2022-23,11/11/2022,202211110WSH,Washington Capitals,WSH,1,TBL,5,8,13,22,11,22,1,2,3,29,15,25
2022-23,11/10/2022,202211100BOS,Boston Bruins,BOS,1,CGY,3,5,8,25,23,11,1,2,3,32,24,7
2022-23,11/10/2022,202211100BUF,Buffalo Sabres,BUF,1,VEG,3,8,11,31,5,15,6,13,19,33,15,22
2022-23,11/10/2022,202211100CAR,Carolina Hurricanes,CAR,1,EDM,7,11,18,29,12,5,2,4,6,21,18,15
2022-23,11/10/2022,202211100CBJ,Columbus Blue Jackets,CBJ,1,PHI,5,5,10,29,12,18,2,4,6,31,10,10
2022-23,11/10/2022,202211100COL,Colorado Avalanche,COL,1,NSH,5,9,14,31,23,20,3,6,9,35,32,12
2022-23,11/10/2022,202211100DET,Detroit Red Wings,DET,1,NYR,2,3,5,20,31,15,7,14,21,29,24,11
2022-23,11/10/2022,202211100LAK,Chicago Blackhawks,CHI,0,LAK,1,1,2,25,32,18,2,4,6,33,18,11
2022-23,11/10/2022,202211100NJD,New Jersey Devils,NJD,1,OTT,4,8,12,41,6,11,3,5,8,26,13,23
2022-23,11/10/2022,202211100NYI,Arizona Coyotes,ARI,0,NYI,2,4,6,25,24,17,0,0,0,24,36,18
2022-23,11/10/2022,202211100STL,San Jose Sharks,SJS,0,STL,3,5,8,29,18,8,5,8,13,31,15,13
2022-23,11/10/2022,202211100BOS,Calgary Flames,CGY,0,BOS,1,2,3,32,24,7,3,5,8,25,23,11
2022-23,11/10/2022,202211100BUF,Vegas Golden Knights,VEG,0,BUF,6,13,19,33,15,22,3,8,11,31,5,15
2022-23,11/10/2022,202211100CAR,Edmonton Oilers,EDM,0,CAR,2,4,6,21,18,15,7,11,18,29,12,5
2022-23,11/10/2022,202211100CBJ,Philadelphia Flyers,PHI,0,CBJ,2,4,6,31,10,10,5,5,10,29,12,18
2022-23,11/10/2022,202211100COL,Nashville Predators,NSH,0,COL,3,6,9,35,32,12,5,9,14,31,23,20
2022-23,11/10/2022,202211100DET,New York Rangers,NYR,0,DET,7,14,21,29,24,11,2,3,5,20,31,15
2022-23,11/10/2022,202211100LAK,Los Angeles Kings,LAK,1,CHI,2,4,6,33,18,11,1,1,2,25,32,18
2022-23,11/10/2022,202211100NJD,Ottawa Senators,OTT,0,NJD,3,5,8,26,13,23,4,8,12,41,6,11
2022-23,11/10/2022,202211100NYI,New York Islanders,NYI,1,ARI,0,0,0,24,36,18,2,4,6,25,24,17
2022-23,11/10/2022,202211100STL,St. Louis Blues,STL,1,SJS,5,8,13,31,15,13,3,5,8,29,18,8
2022-23,11/9/2022,202211090ANA,Anaheim Ducks,ANA,1,MIN,1,2,3,32,18,13,3,7,10,38,14,12
2022-23,11/9/2022,202211090FLA,Carolina Hurricanes,CAR,0,FLA,0,0,0,39,23,8,3,6,9,33,22,11
2022-23,11/9/2022,202211090MTL,Montreal Canadiens,MTL,1,VAN,5,6,11,29,9,15,2,3,5,31,16,8
2022-23,11/9/2022,202211090WSH,Pittsburgh Penguins,PIT,0,WSH,4,7,11,27,24,15,1,2,3,25,33,15
2022-23,11/9/2022,202211090ANA,Minnesota Wild,MIN,0,ANA,3,7,10,38,14,12,1,2,3,32,18,13
2022-23,11/9/2022,202211090FLA,Florida Panthers,FLA,1,CAR,3,6,9,33,22,11,0,0,0,39,23,8
2022-23,11/9/2022,202211090MTL,Vancouver Canucks,VAN,0,MTL,2,3,5,31,16,8,5,6,11,29,9,15
2022-23,11/9/2022,202211090WSH,Washington Capitals,WSH,1,PIT,1,2,3,25,33,15,4,7,11,27,24,15
2022-23,11/8/2022,202211080BUF,Arizona Coyotes,ARI,0,BUF,4,7,11,23,10,8,1,2,3,31,12,4
2022-23,11/8/2022,202211080DET,Detroit Red Wings,DET,1,MTL,2,4,6,41,19,11,2,4,6,33,13,17
2022-23,11/8/2022,202211080LAK,Los Angeles Kings,LAK,1,MIN,1,2,3,27,24,11,0,0,0,21,29,22
2022-23,11/8/2022,202211080NJD,Calgary Flames,CGY,0,NJD,2,4,6,33,26,18,3,6,9,20,21,9
2022-23,11/8/2022,202211080NYR,New York Islanders,NYI,0,NYR,4,7,11,23,16,16,3,6,9,38,29,14
2022-23,11/8/2022,202211080OTT,Ottawa Senators,OTT,1,VAN,4,5,9,38,23,10,6,8,14,28,24,16
2022-23,11/8/2022,202211080PHI,Philadelphia Flyers,PHI,1,STL,3,9,12,27,29,12,1,2,3,26,32,9
2022-23,11/8/2022,202211080SEA,Nashville Predators,NSH,0,SEA,1,0,1,25,21,14,5,6,11,19,16,21
2022-23,11/8/2022,202211080TBL,Edmonton Oilers,EDM,0,TBL,3,5,8,29,28,18,2,4,6,37,25,13
2022-23,11/8/2022,202211080TOR,Toronto Maple Leafs,TOR,1,VEG,3,6,9,31,31,9,4,7,11,20,41,12
2022-23,11/8/2022,202211080WPG,Dallas Stars,DAL,0,WPG,1,1,2,22,24,10,4,10,14,31,21,14
2022-23,11/8/2022,202211080BUF,Buffalo Sabres,BUF,1,ARI,1,2,3,31,12,4,4,7,11,23,10,8
2022-23,11/8/2022,202211080DET,Montreal Canadiens,MTL,0,DET,2,4,6,33,13,17,2,4,6,41,19,11
2022-23,11/8/2022,202211080LAK,Minnesota Wild,MIN,0,LAK,0,0,0,21,29,22,1,2,3,27,24,11
2022-23,11/8/2022,202211080NJD,New Jersey Devils,NJD,1,CGY,3,6,9,20,21,9,2,4,6,33,26,18
2022-23,11/8/2022,202211080NYR,New York Rangers,NYR,1,NYI,3,6,9,38,29,14,4,7,11,23,16,16
2022-23,11/8/2022,202211080OTT,Vancouver Canucks,VAN,0,OTT,6,8,14,28,24,16,4,5,9,38,23,10
2022-23,11/8/2022,202211080PHI,St. Louis Blues,STL,0,PHI,1,2,3,26,32,9,3,9,12,27,29,12
2022-23,11/8/2022,202211080SEA,Seattle Kraken,SEA,1,NSH,5,6,11,19,16,21,1,0,1,25,21,14
2022-23,11/8/2022,202211080TBL,Tampa Bay Lightning,TBL,1,EDM,2,4,6,37,25,13,3,5,8,29,28,18
2022-23,11/8/2022,202211080TOR,Vegas Golden Knights,VEG,0,TOR,4,7,11,20,41,12,3,6,9,31,31,9
2022-23,11/8/2022,202211080WPG,Winnipeg Jets,WPG,1,DAL,4,10,14,31,21,14,1,1,2,22,24,10
2022-23,11/7/2022,202211070BOS,Boston Bruins,BOS,1,STL,2,3,5,30,19,11,1,2,3,27,33,19
2022-23,11/7/2022,202211070NYI,Calgary Flames,CGY,0,NYI,3,5,8,43,24,18,4,5,9,31,33,17
2022-23,11/7/2022,202211070WSH,Edmonton Oilers,EDM,0,WSH,4,7,11,29,20,18,5,7,12,30,13,10
2022-23,11/7/2022,202211070BOS,St. Louis Blues,STL,0,BOS,1,2,3,27,33,19,2,3,5,30,19,11
2022-23,11/7/2022,202211070NYI,New York Islanders,NYI,1,CGY,4,5,9,31,33,17,3,5,8,43,24,18
2022-23,11/7/2022,202211070WSH,Washington Capitals,WSH,1,EDM,5,7,12,30,13,10,4,7,11,29,20,18
2022-23,11/6/2022,202211060ANA,Anaheim Ducks,ANA,1,FLA,3,4,7,35,17,27,5,9,14,41,12,11
2022-23,11/6/2022,202211060CAR,Carolina Hurricanes,CAR,1,TOR,1,2,3,25,24,9,3,5,8,16,16,14
2022-23,11/6/2022,202211060NYR,Detroit Red Wings,DET,0,NYR,2,6,8,34,22,22,2,4,6,28,28,15
2022-23,11/6/2022,202211060ANA,Florida Panthers,FLA,0,ANA,5,9,14,41,12,11,3,4,7,35,17,27
2022-23,11/6/2022,202211060CAR,Toronto Maple Leafs,TOR,0,CAR,3,5,8,16,16,14,1,2,3,25,24,9
2022-23,11/6/2022,202211060NYR,New York Rangers,NYR,1,DET,2,4,6,28,28,15,2,6,8,34,22,22
2022-23,11/5/2022,202211050CBJ,Columbus Blue Jackets,CBJ,1,COL,1,2,3,32,13,20,4,9,13,39,9,13
2022-23,11/5/2022,202211050CGY,Calgary Flames,CGY,1,NJD,3,5,8,29,38,14,4,8,12,35,14,15
2022-23,11/5/2022,202211050DET,Detroit Red Wings,DET,1,NYI,3,5,8,25,20,24,0,0,0,24,34,10
2022-23,11/5/2022,202211050EDM,Dallas Stars,DAL,0,EDM,6,12,18,36,25,13,2,4,6,29,29,12
2022-23,11/5/2022,202211050LAK,Florida Panthers,FLA,0,LAK,4,5,9,38,21,14,5,9,14,39,23,17
2022-23,11/5/2022,202211050MTL,Montreal Canadiens,MTL,1,VEG,4,7,11,29,8,26,6,8,14,41,18,18
2022-23,11/5/2022,202211050OTT,Ottawa Senators,OTT,1,PHI,1,2,3,30,32,15,2,2,4,22,21,22
2022-23,11/5/2022,202211050PIT,Pittsburgh Penguins,PIT,1,SEA,2,4,6,37,34,8,3,5,8,28,35,18
2022-23,11/5/2022,202211050SJS,Anaheim Ducks,ANA,0,SJS,4,7,11,24,15,17,4,7,11,50,20,9
2022-23,11/5/2022,202211050TBL,Buffalo Sabres,BUF,0,TBL,3,6,9,21,40,8,5,8,13,30,43,17
2022-23,11/5/2022,202211050TOR,Boston Bruins,BOS,0,TOR,1,0,1,18,44,8,2,4,6,23,19,14
2022-23,11/5/2022,202211050VAN,Nashville Predators,NSH,0,VAN,1,6,7,26,34,14,3,6,9,38,19,15
2022-23,11/5/2022,202211050WPG,Chicago Blackhawks,CHI,0,WPG,0,0,0,27,26,12,4,7,11,32,19,10
2022-23,11/5/2022,202211050WSH,Arizona Coyotes,ARI,0,WSH,1,6,7,23,16,12,2,2,4,34,20,12
2022-23,11/5/2022,202211050CBJ,Colorado Avalanche,COL,0,CBJ,4,9,13,39,9,13,1,2,3,32,13,20
2022-23,11/5/2022,202211050CGY,New Jersey Devils,NJD,0,CGY,4,8,12,35,14,15,3,5,8,29,38,14
2022-23,11/5/2022,202211050DET,New York Islanders,NYI,0,DET,0,0,0,24,34,10,3,5,8,25,20,24
2022-23,11/5/2022,202211050EDM,Edmonton Oilers,EDM,1,DAL,2,4,6,29,29,12,6,12,18,36,25,13
2022-23,11/5/2022,202211050LAK,Los Angeles Kings,LAK,1,FLA,5,9,14,39,23,17,4,5,9,38,21,14
2022-23,11/5/2022,202211050MTL,Vegas Golden Knights,VEG,0,MTL,6,8,14,41,18,18,4,7,11,29,8,26
2022-23,11/5/2022,202211050OTT,Philadelphia Flyers,PHI,0,OTT,2,2,4,22,21,22,1,2,3,30,32,15
2022-23,11/5/2022,202211050PIT,Seattle Kraken,SEA,0,PIT,3,5,8,28,35,18,2,4,6,37,34,8
2022-23,11/5/2022,202211050SJS,San Jose Sharks,SJS,1,ANA,4,7,11,50,20,9,4,7,11,24,15,17
2022-23,11/5/2022,202211050TBL,Tampa Bay Lightning,TBL,1,BUF,5,8,13,30,43,17,3,6,9,21,40,8
2022-23,11/5/2022,202211050TOR,Toronto Maple Leafs,TOR,1,BOS,2,4,6,23,19,14,1,0,1,18,44,8
2022-23,11/5/2022,202211050VAN,Vancouver Canucks,VAN,1,NSH,3,6,9,38,19,15,1,6,7,26,34,14
2022-23,11/5/2022,202211050WPG,Winnipeg Jets,WPG,1,CHI,4,7,11,32,19,10,0,0,0,27,26,12
2022-23,11/5/2022,202211050WSH,Washington Capitals,WSH,1,ARI,2,2,4,34,20,12,1,6,7,23,16,12
2022-23,11/4/2022,202211040CAR,Buffalo Sabres,BUF,0,CAR,3,5,8,24,13,8,5,9,14,32,18,9
2022-23,11/4/2022,202211040COL,Columbus Blue Jackets,CBJ,0,COL,2,6,8,36,18,13,6,12,18,34,4,17
2022-23,11/4/2022,202211040CAR,Carolina Hurricanes,CAR,1,BUF,5,9,14,32,18,9,3,5,8,24,13,8
2022-23,11/4/2022,202211040COL,Colorado Avalanche,COL,1,CBJ,6,12,18,34,4,17,2,6,8,36,18,13
2022-23,11/3/2022,202211030ARI,Arizona Coyotes,ARI,1,DAL,2,3,5,27,27,13,7,10,17,36,13,12
2022-23,11/3/2022,202211030CGY,Calgary Flames,CGY,1,NSH,1,1,2,28,38,12,4,8,12,30,25,22
2022-23,11/3/2022,202211030CHI,Chicago Blackhawks,CHI,1,LAK,1,4,5,17,25,22,1,2,3,31,19,9
2022-23,11/3/2022,202211030DET,Detroit Red Wings,DET,1,WSH,3,6,9,24,24,19,1,1,2,31,16,7
2022-23,11/3/2022,202211030EDM,Edmonton Oilers,EDM,1,NJD,3,6,9,36,21,16,4,7,11,43,24,10
2022-23,11/3/2022,202211030MIN,Minnesota Wild,MIN,1,SEA,0,0,0,22,24,8,4,8,12,23,20,14
2022-23,11/3/2022,202211030NYR,Boston Bruins,BOS,0,NYR,5,7,12,33,20,9,2,4,6,20,39,16
2022-23,11/3/2022,202211030OTT,Ottawa Senators,OTT,1,VEG,4,6,10,42,18,6,5,4,9,30,26,21
2022-23,11/3/2022,202211030SJS,Florida Panthers,FLA,0,SJS,3,6,9,41,21,13,3,5,8,38,19,18
2022-23,11/3/2022,202211030STL,New York Islanders,NYI,0,STL,4,8,12,27,20,9,2,4,6,34,25,8
2022-23,11/3/2022,202211030TBL,Carolina Hurricanes,CAR,0,TBL,3,3,6,53,38,10,3,5,8,26,32,22
2022-23,11/3/2022,202211030VAN,Anaheim Ducks,ANA,0,VAN,5,7,12,25,13,5,8,13,21,43,19,12
2022-23,11/3/2022,202211030WPG,Montreal Canadiens,MTL,0,WPG,2,4,6,22,23,15,3,6,9,36,30,6
2022-23,11/3/2022,202211030ARI,Dallas Stars,DAL,0,ARI,7,10,17,36,13,12,2,3,5,27,27,13
2022-23,11/3/2022,202211030CGY,Nashville Predators,NSH,0,CGY,4,8,12,30,25,22,1,1,2,28,38,12
2022-23,11/3/2022,202211030CHI,Los Angeles Kings,LAK,0,CHI,1,2,3,31,19,9,1,4,5,17,25,22
2022-23,11/3/2022,202211030DET,Washington Capitals,WSH,0,DET,1,1,2,31,16,7,3,6,9,24,24,19
2022-23,11/3/2022,202211030EDM,New Jersey Devils,NJD,0,EDM,4,7,11,43,24,10,3,6,9,36,21,16
2022-23,11/3/2022,202211030MIN,Seattle Kraken,SEA,0,MIN,4,8,12,23,20,14,0,0,0,22,24,8
2022-23,11/3/2022,202211030NYR,New York Rangers,NYR,1,BOS,2,4,6,20,39,16,5,7,12,33,20,9
2022-23,11/3/2022,202211030OTT,Vegas Golden Knights,VEG,0,OTT,5,4,9,30,26,21,4,6,10,42,18,6
2022-23,11/3/2022,202211030SJS,San Jose Sharks,SJS,1,FLA,3,5,8,38,19,18,3,6,9,41,21,13
2022-23,11/3/2022,202211030STL,St. Louis Blues,STL,1,NYI,2,4,6,34,25,8,4,8,12,27,20,9
2022-23,11/3/2022,202211030TBL,Tampa Bay Lightning,TBL,1,CAR,3,5,8,26,32,22,3,3,6,53,38,10
2022-23,11/3/2022,202211030VAN,Vancouver Canucks,VAN,1,ANA,8,13,21,43,19,12,5,7,12,25,13,5
2022-23,11/3/2022,202211030WPG,Winnipeg Jets,WPG,1,MTL,3,6,9,36,30,6,2,4,6,22,23,15
2022-23,11/2/2022,202211020BUF,Buffalo Sabres,BUF,1,PIT,6,9,15,28,8,12,2,5,7,20,12,12
2022-23,11/2/2022,202211020TOR,Philadelphia Flyers,PHI,0,TOR,2,4,6,22,36,18,5,9,14,40,31,8
2022-23,11/2/2022,202211020BUF,Pittsburgh Penguins,PIT,0,BUF,2,5,7,20,12,12,6,9,15,28,8,12
2022-23,11/2/2022,202211020TOR,Toronto Maple Leafs,TOR,1,PHI,5,9,14,40,31,8,2,4,6,22,36,18
2022-23,11/1/2022,202211010ARI,Arizona Coyotes,ARI,1,FLA,2,5,7,19,25,20,1,2,3,37,15,7
2022-23,11/1/2022,202211010CGY,Calgary Flames,CGY,1,SEA,4,5,9,38,20,12,5,6,11,26,18,19
2022-23,11/1/2022,202211010CHI,Chicago Blackhawks,CHI,1,NYI,0,2,2,21,25,14,3,3,6,33,20,12
2022-23,11/1/2022,202211010DAL,Dallas Stars,DAL,1,LAK,5,8,13,40,19,14,2,4,6,31,22,19
2022-23,11/1/2022,202211010EDM,Edmonton Oilers,EDM,1,NSH,7,13,20,33,24,9,4,8,12,23,60,24
2022-23,11/1/2022,202211010MIN,Minnesota Wild,MIN,1,MTL,4,7,11,31,14,7,1,1,2,32,16,12
2022-23,11/1/2022,202211010NYR,New York Rangers,NYR,1,PHI,1,1,2,36,27,14,0,0,0,14,9,13
2022-23,11/1/2022,202211010PIT,Boston Bruins,BOS,0,PIT,6,9,15,36,34,19,4,8,12,36,44,11
2022-23,11/1/2022,202211010SJS,Anaheim Ducks,ANA,0,SJS,5,8,13,42,15,8,5,7,12,42,15,13
2022-23,11/1/2022,202211010TBL,Ottawa Senators,OTT,0,TBL,2,1,3,11,29,17,4,8,12,34,32,21
2022-23,11/1/2022,202211010VAN,New Jersey Devils,NJD,0,VAN,5,8,13,37,14,17,2,4,6,23,21,9
2022-23,11/1/2022,202211010WSH,Vegas Golden Knights,VEG,0,WSH,3,6,9,30,27,23,2,3,5,19,26,23
2022-23,11/1/2022,202211010ARI,Florida Panthers,FLA,0,ARI,1,2,3,37,15,7,2,5,7,19,25,20
2022-23,11/1/2022,202211010CGY,Seattle Kraken,SEA,0,CGY,5,6,11,26,18,19,4,5,9,38,20,12
2022-23,11/1/2022,202211010CHI,New York Islanders,NYI,0,CHI,3,3,6,33,20,12,0,2,2,21,25,14
2022-23,11/1/2022,202211010DAL,Los Angeles Kings,LAK,0,DAL,2,4,6,31,22,19,5,8,13,40,19,14
2022-23,11/1/2022,202211010EDM,Nashville Predators,NSH,0,EDM,4,8,12,23,60,24,7,13,20,33,24,9
2022-23,11/1/2022,202211010MIN,Montreal Canadiens,MTL,0,MIN,1,1,2,32,16,12,4,7,11,31,14,7
2022-23,11/1/2022,202211010NYR,Philadelphia Flyers,PHI,0,NYR,0,0,0,14,9,13,1,1,2,36,27,14
2022-23,11/1/2022,202211010PIT,Pittsburgh Penguins,PIT,1,BOS,4,8,12,36,44,11,6,9,15,36,34,19
2022-23,11/1/2022,202211010SJS,San Jose Sharks,SJS,1,ANA,5,7,12,42,15,13,5,8,13,42,15,8
2022-23,11/1/2022,202211010TBL,Tampa Bay Lightning,TBL,1,OTT,4,8,12,34,32,21,2,1,3,11,29,17
2022-23,11/1/2022,202211010VAN,Vancouver Canucks,VAN,1,NJD,2,4,6,23,21,9,5,8,13,37,14,17
2022-23,11/1/2022,202211010WSH,Washington Capitals,WSH,1,VEG,2,3,5,19,26,23,3,6,9,30,27,23
2022-23,10/31/2022,202210310BUF,Buffalo Sabres,BUF,1,DET,7,14,21,42,9,1,3,4,7,18,18,12
2022-23,10/31/2022,202210310CAR,Carolina Hurricanes,CAR,1,WSH,2,3,5,34,20,7,2,4,6,19,28,19
2022-23,10/31/2022,202210310STL,Los Angeles Kings,LAK,0,STL,5,10,15,30,16,11,1,2,3,27,32,9
2022-23,10/31/2022,202210310BUF,Detroit Red Wings,DET,0,BUF,3,4,7,18,18,12,7,14,21,42,9,1
2022-23,10/31/2022,202210310CAR,Washington Capitals,WSH,0,CAR,2,4,6,19,28,19,2,3,5,34,20,7
2022-23,10/31/2022,202210310STL,St. Louis Blues,STL,1,LAK,1,2,3,27,32,9,5,10,15,30,16,11
2022-23,10/30/2022,202210300ANA,Anaheim Ducks,ANA,1,TOR,4,5,9,36,17,8,2,6,8,33,8,11
2022-23,10/30/2022,202210300ARI,Arizona Coyotes,ARI,1,NYR,2,4,6,15,22,6,3,5,8,39,34,11
2022-23,10/30/2022,202210300CHI,Chicago Blackhawks,CHI,1,MIN,2,6,8,23,28,14,3,5,8,35,15,11
2022-23,10/30/2022,202210300NJD,Columbus Blue Jackets,CBJ,0,NJD,1,2,3,19,27,20,7,9,16,53,13,12
2022-23,10/30/2022,202210300VEG,Vegas Golden Knights,VEG,1,WPG,2,3,5,43,21,20,1,2,3,23,41,15
2022-23,10/30/2022,202210300ANA,Toronto Maple Leafs,TOR,0,ANA,2,6,8,33,8,11,4,5,9,36,17,8
2022-23,10/30/2022,202210300ARI,New York Rangers,NYR,0,ARI,3,5,8,39,34,11,2,4,6,15,22,6
2022-23,10/30/2022,202210300CHI,Minnesota Wild,MIN,0,CHI,3,5,8,35,15,11,2,6,8,23,28,14
2022-23,10/30/2022,202210300NJD,New Jersey Devils,NJD,1,CBJ,7,9,16,53,13,12,1,2,3,19,27,20
2022-23,10/30/2022,202210300VEG,Winnipeg Jets,WPG,0,VEG,1,2,3,23,41,15,2,3,5,43,21,20
2022-23,10/29/2022,202210290BUF,Buffalo Sabres,BUF,1,CHI,4,7,11,45,6,10,3,5,8,26,11,23
2022-23,10/29/2022,202210290CGY,Calgary Flames,CGY,1,EDM,1,3,4,37,27,13,3,5,8,26,23,15
2022-23,10/29/2022,202210290DAL,Dallas Stars,DAL,1,NYR,3,3,6,33,13,17,6,12,18,27,18,16
2022-23,10/29/2022,202210290DET,Detroit Red Wings,DET,1,MIN,2,4,6,22,30,14,1,2,3,31,25,13
2022-23,10/29/2022,202210290FLA,Florida Panthers,FLA,1,OTT,5,8,13,50,24,11,2,4,6,25,35,14
2022-23,10/29/2022,202210290LAK,Los Angeles Kings,LAK,1,TOR,4,5,9,28,17,9,2,4,6,27,20,12
2022-23,10/29/2022,202210290NSH,Nashville Predators,NSH,1,WSH,0,0,0,34,36,14,3,4,7,35,28,14
2022-23,10/29/2022,202210290NYI,Colorado Avalanche,COL,0,NYI,4,7,11,37,21,10,5,7,12,42,25,15
2022-23,10/29/2022,202210290PHI,Carolina Hurricanes,CAR,0,PHI,4,6,10,35,27,8,2,3,5,22,21,12
2022-23,10/29/2022,202210290SEA,Pittsburgh Penguins,PIT,0,SEA,1,0,1,31,23,16,3,6,9,30,25,14
2022-23,10/29/2022,202210290SJS,San Jose Sharks,SJS,1,TBL,3,5,8,25,14,7,4,7,11,26,21,13
2022-23,10/29/2022,202210290STL,Montreal Canadiens,MTL,0,STL,7,10,17,24,16,10,4,7,11,30,28,5
2022-23,10/29/2022,202210290BUF,Chicago Blackhawks,CHI,0,BUF,3,5,8,26,11,23,4,7,11,45,6,10
2022-23,10/29/2022,202210290CGY,Edmonton Oilers,EDM,0,CGY,3,5,8,26,23,15,1,3,4,37,27,13
2022-23,10/29/2022,202210290DAL,New York Rangers,NYR,0,DAL,6,12,18,27,18,16,3,3,6,33,13,17
2022-23,10/29/2022,202210290DET,Minnesota Wild,MIN,0,DET,1,2,3,31,25,13,2,4,6,22,30,14
2022-23,10/29/2022,202210290FLA,Ottawa Senators,OTT,0,FLA,2,4,6,25,35,14,5,8,13,50,24,11
2022-23,10/29/2022,202210290LAK,Toronto Maple Leafs,TOR,0,LAK,2,4,6,27,20,12,4,5,9,28,17,9
2022-23,10/29/2022,202210290NSH,Washington Capitals,WSH,0,NSH,3,4,7,35,28,14,0,0,0,34,36,14
2022-23,10/29/2022,202210290NYI,New York Islanders,NYI,1,COL,5,7,12,42,25,15,4,7,11,37,21,10
2022-23,10/29/2022,202210290PHI,Philadelphia Flyers,PHI,1,CAR,2,3,5,22,21,12,4,6,10,35,27,8
2022-23,10/29/2022,202210290SEA,Seattle Kraken,SEA,1,PIT,3,6,9,30,25,14,1,0,1,31,23,16
2022-23,10/29/2022,202210290SJS,Tampa Bay Lightning,TBL,0,SJS,4,7,11,26,21,13,3,5,8,25,14,7
2022-23,10/29/2022,202210290STL,St. Louis Blues,STL,1,MTL,4,7,11,30,28,5,7,10,17,24,16,10
2022-23,10/28/2022,202210280ARI,Arizona Coyotes,ARI,1,WPG,2,2,4,20,28,12,3,3,6,35,17,11
2022-23,10/28/2022,202210280CAR,Carolina Hurricanes,CAR,1,NYI,2,3,5,35,21,10,5,9,14,30,29,28
2022-23,10/28/2022,202210280CBJ,Boston Bruins,BOS,0,CBJ,4,2,6,34,21,18,0,0,0,29,17,15
2022-23,10/28/2022,202210280NJD,Colorado Avalanche,COL,0,NJD,0,0,0,23,17,15,1,2,3,23,11,17
2022-23,10/28/2022,202210280VAN,Pittsburgh Penguins,PIT,0,VAN,1,2,3,33,17,9,5,7,12,27,21,18
2022-23,10/28/2022,202210280VEG,Anaheim Ducks,ANA,0,VEG,0,0,0,27,23,9,4,8,12,22,20,18
2022-23,10/28/2022,202210280ARI,Winnipeg Jets,WPG,0,ARI,3,3,6,35,17,11,2,2,4,20,28,12
2022-23,10/28/2022,202210280CAR,New York Islanders,NYI,0,CAR,5,9,14,30,29,28,2,3,5,35,21,10
2022-23,10/28/2022,202210280CBJ,Columbus Blue Jackets,CBJ,1,BOS,0,0,0,29,17,15,4,2,6,34,21,18
2022-23,10/28/2022,202210280NJD,New Jersey Devils,NJD,1,COL,1,2,3,23,11,17,0,0,0,23,17,15
2022-23,10/28/2022,202210280VAN,Vancouver Canucks,VAN,1,PIT,5,7,12,27,21,18,1,2,3,33,17,9
2022-23,10/28/2022,202210280VEG,Vegas Golden Knights,VEG,1,ANA,4,8,12,22,20,18,0,0,0,27,23,9
2022-23,10/27/2022,202210270BOS,Boston Bruins,BOS,1,DET,5,9,14,28,23,7,1,1,2,26,31,9
2022-23,10/27/2022,202210270BUF,Buffalo Sabres,BUF,1,MTL,2,3,5,42,4,13,3,5,8,33,6,13
2022-23,10/27/2022,202210270CHI,Chicago Blackhawks,CHI,1,EDM,4,9,13,33,29,7,6,12,18,37,11,6
2022-23,10/27/2022,202210270DAL,Dallas Stars,DAL,1,WSH,2,2,4,27,10,16,0,0,0,27,21,15
2022-23,10/27/2022,202210270LAK,Los Angeles Kings,LAK,1,WPG,4,6,10,43,21,6,6,9,15,19,24,22
2022-23,10/27/2022,202210270NSH,Nashville Predators,NSH,1,STL,6,11,17,42,35,9,2,3,5,34,25,18
2022-23,10/27/2022,202210270OTT,Minnesota Wild,MIN,0,OTT,4,6,10,40,25,24,2,4,6,26,33,10
2022-23,10/27/2022,202210270PHI,Florida Panthers,FLA,0,PHI,3,6,9,46,22,8,4,8,12,22,30,27
2022-23,10/27/2022,202210270SEA,Seattle Kraken,SEA,1,VAN,4,8,12,34,13,8,5,6,11,17,21,13
2022-23,10/27/2022,202210270SJS,San Jose Sharks,SJS,1,TOR,4,7,11,28,20,10,3,6,9,23,11,10
2022-23,10/27/2022,202210270BOS,Detroit Red Wings,DET,0,BOS,1,1,2,26,31,9,5,9,14,28,23,7
2022-23,10/27/2022,202210270BUF,Montreal Canadiens,MTL,0,BUF,3,5,8,33,6,13,2,3,5,42,4,13
2022-23,10/27/2022,202210270CHI,Edmonton Oilers,EDM,0,CHI,6,12,18,37,11,6,4,9,13,33,29,7
2022-23,10/27/2022,202210270DAL,Washington Capitals,WSH,0,DAL,0,0,0,27,21,15,2,2,4,27,10,16
2022-23,10/27/2022,202210270LAK,Winnipeg Jets,WPG,0,LAK,6,9,15,19,24,22,4,6,10,43,21,6
2022-23,10/27/2022,202210270NSH,St. Louis Blues,STL,0,NSH,2,3,5,34,25,18,6,11,17,42,35,9
2022-23,10/27/2022,202210270OTT,Ottawa Senators,OTT,1,MIN,2,4,6,26,33,10,4,6,10,40,25,24
2022-23,10/27/2022,202210270PHI,Philadelphia Flyers,PHI,1,FLA,4,8,12,22,30,27,3,6,9,46,22,8
2022-23,10/27/2022,202210270SEA,Vancouver Canucks,VAN,0,SEA,5,6,11,17,21,13,4,8,12,34,13,8
2022-23,10/27/2022,202210270SJS,Toronto Maple Leafs,TOR,0,SJS,3,6,9,23,11,10,4,7,11,28,20,10
2022-23,10/26/2022,202210260ANA,Anaheim Ducks,ANA,1,TBL,2,2,4,19,14,18,4,7,11,30,15,19
2022-23,10/26/2022,202210260NYI,New York Islanders,NYI,1,NYR,2,6,8,28,35,15,0,0,0,39,41,14
2022-23,10/26/2022,202210260STL,Edmonton Oilers,EDM,0,STL,3,6,9,27,6,9,1,2,3,36,21,19
2022-23,10/26/2022,202210260ANA,Tampa Bay Lightning,TBL,0,ANA,4,7,11,30,15,19,2,2,4,19,14,18
2022-23,10/26/2022,202210260NYI,New York Rangers,NYR,0,NYI,0,0,0,39,41,14,2,6,8,28,35,15
2022-23,10/26/2022,202210260STL,St. Louis Blues,STL,1,EDM,1,2,3,36,21,19,3,6,9,27,6,9
2022-23,10/25/2022,202210250BOS,Boston Bruins,BOS,1,DAL,2,3,5,24,26,11,1,2,3,31,32,5
2022-23,10/25/2022,202210250CBJ,Arizona Coyotes,ARI,0,CBJ,5,10,15,17,11,14,3,6,9,32,24,8
2022-23,10/25/2022,202210250CGY,Calgary Flames,CGY,1,PIT,3,5,8,33,13,14,1,2,3,32,13,19
2022-23,10/25/2022,202210250CHI,Chicago Blackhawks,CHI,1,FLA,3,7,10,21,29,19,2,4,6,26,12,6
2022-23,10/25/2022,202210250DET,Detroit Red Wings,DET,1,NJD,2,4,6,21,29,12,6,10,16,41,16,13
2022-23,10/25/2022,202210250LAK,Los Angeles Kings,LAK,1,TBL,4,7,11,32,28,19,2,2,4,25,16,20
2022-23,10/25/2022,202210250MTL,Minnesota Wild,MIN,0,MTL,3,3,6,31,19,21,1,1,2,27,10,18
2022-23,10/25/2022,202210250NYR,Colorado Avalanche,COL,0,NYR,2,3,5,44,21,12,2,4,6,46,36,15
2022-23,10/25/2022,202210250SEA,Buffalo Sabres,BUF,0,SEA,1,2,3,15,11,5,5,9,14,23,14,17
2022-23,10/25/2022,202210250SJS,San Jose Sharks,SJS,1,VEG,2,2,4,28,19,14,3,7,10,28,14,27
2022-23,10/25/2022,202210250BOS,Dallas Stars,DAL,0,BOS,1,2,3,31,32,5,2,3,5,24,26,11
2022-23,10/25/2022,202210250CBJ,Columbus Blue Jackets,CBJ,1,ARI,3,6,9,32,24,8,5,10,15,17,11,14
2022-23,10/25/2022,202210250CGY,Pittsburgh Penguins,PIT,0,CGY,1,2,3,32,13,19,3,5,8,33,13,14
2022-23,10/25/2022,202210250CHI,Florida Panthers,FLA,0,CHI,2,4,6,26,12,6,3,7,10,21,29,19
2022-23,10/25/2022,202210250DET,New Jersey Devils,NJD,0,DET,6,10,16,41,16,13,2,4,6,21,29,12
2022-23,10/25/2022,202210250LAK,Tampa Bay Lightning,TBL,0,LAK,2,2,4,25,16,20,4,7,11,32,28,19
2022-23,10/25/2022,202210250MTL,Montreal Canadiens,MTL,1,MIN,1,1,2,27,10,18,3,3,6,31,19,21
2022-23,10/25/2022,202210250NYR,New York Rangers,NYR,1,COL,2,4,6,46,36,15,2,3,5,44,21,12
2022-23,10/25/2022,202210250SEA,Seattle Kraken,SEA,1,BUF,5,9,14,23,14,17,1,2,3,15,11,5
2022-23,10/25/2022,202210250SJS,Vegas Golden Knights,VEG,0,SJS,3,7,10,28,14,27,2,2,4,28,19,14
2022-23,10/24/2022,202210240EDM,Edmonton Oilers,EDM,1,PIT,6,9,15,44,23,12,3,5,8,33,27,7
2022-23,10/24/2022,202210240NJD,New Jersey Devils,NJD,1,WSH,3,6,9,41,13,11,6,10,16,22,31,12
2022-23,10/24/2022,202210240OTT,Dallas Stars,DAL,0,OTT,2,2,4,31,20,21,3,6,9,31,30,11
2022-23,10/24/2022,202210240VAN,Carolina Hurricanes,CAR,0,VAN,3,6,9,36,11,14,2,4,6,13,26,9
2022-23,10/24/2022,202210240VEG,Toronto Maple Leafs,TOR,0,VEG,1,2,3,22,19,18,3,4,7,33,34,28
2022-23,10/24/2022,202210240WPG,St. Louis Blues,STL,0,WPG,0,0,0,23,15,16,4,8,12,42,36,13
2022-23,10/24/2022,202210240EDM,Pittsburgh Penguins,PIT,0,EDM,3,5,8,33,27,7,6,9,15,44,23,12
2022-23,10/24/2022,202210240NJD,Washington Capitals,WSH,0,NJD,6,10,16,22,31,12,3,6,9,41,13,11
2022-23,10/24/2022,202210240OTT,Ottawa Senators,OTT,1,DAL,3,6,9,31,30,11,2,2,4,31,20,21
2022-23,10/24/2022,202210240VAN,Vancouver Canucks,VAN,1,CAR,2,4,6,13,26,9,3,6,9,36,11,14
2022-23,10/24/2022,202210240VEG,Vegas Golden Knights,VEG,1,TOR,3,4,7,33,34,28,1,2,3,22,19,18
2022-23,10/24/2022,202210240WPG,Winnipeg Jets,WPG,1,STL,4,8,12,42,36,13,0,0,0,23,15,16
2022-23,10/23/2022,202210230CHI,Chicago Blackhawks,CHI,1,SEA,5,6,11,26,40,14,4,6,10,33,8,8
2022-23,10/23/2022,202210230DET,Anaheim Ducks,ANA,0,DET,1,2,3,30,13,8,4,9,13,39,27,16
2022-23,10/23/2022,202210230FLA,Florida Panthers,FLA,1,NYI,3,2,5,29,9,9,2,4,6,22,29,20
2022-23,10/23/2022,202210230NYR,Columbus Blue Jackets,CBJ,0,NYR,5,7,12,21,15,20,1,0,1,31,24,13
2022-23,10/23/2022,202210230PHI,Philadelphia Flyers,PHI,1,SJS,0,0,0,23,26,12,3,6,9,21,25,12
2022-23,10/23/2022,202210230CHI,Seattle Kraken,SEA,0,CHI,4,6,10,33,8,8,5,6,11,26,40,14
2022-23,10/23/2022,202210230DET,Detroit Red Wings,DET,1,ANA,4,9,13,39,27,16,1,2,3,30,13,8
2022-23,10/23/2022,202210230FLA,New York Islanders,NYI,0,FLA,2,4,6,22,29,20,3,2,5,29,9,9
2022-23,10/23/2022,202210230NYR,New York Rangers,NYR,1,CBJ,1,0,1,31,24,13,5,7,12,21,15,20
2022-23,10/23/2022,202210230PHI,San Jose Sharks,SJS,0,PHI,3,6,9,21,25,12,0,0,0,23,26,12
2022-23,10/22/2022,202210220BOS,Boston Bruins,BOS,1,MIN,4,6,10,38,23,8,3,6,9,27,21,20
2022-23,10/22/2022,202210220CBJ,Columbus Blue Jackets,CBJ,1,PIT,3,2,5,30,31,15,5,9,14,38,10,16
2022-23,10/22/2022,202210220CGY,Carolina Hurricanes,CAR,0,CGY,2,2,4,23,19,7,2,3,5,30,24,15
2022-23,10/22/2022,202210220EDM,Edmonton Oilers,EDM,1,STL,0,0,0,23,27,7,2,3,5,22,29,25
2022-23,10/22/2022,202210220MTL,Dallas Stars,DAL,0,MTL,5,8,13,30,16,13,2,4,6,33,25,13
2022-23,10/22/2022,202210220NJD,New Jersey Devils,NJD,1,SJS,2,2,4,36,25,17,1,1,2,18,29,8
2022-23,10/22/2022,202210220NSH,Nashville Predators,NSH,1,PHI,1,2,3,32,38,11,3,5,8,20,17,20
2022-23,10/22/2022,202210220OTT,Arizona Coyotes,ARI,0,OTT,2,3,5,18,18,10,6,10,16,31,26,9
2022-23,10/22/2022,202210220TBL,New York Islanders,NYI,0,TBL,3,1,4,35,45,9,5,9,14,26,29,20
2022-23,10/22/2022,202210220VAN,Buffalo Sabres,BUF,0,VAN,5,7,12,23,14,18,1,2,3,28,40,14
2022-23,10/22/2022,202210220VEG,Colorado Avalanche,COL,0,VEG,3,5,8,25,38,16,2,4,6,33,41,27
2022-23,10/22/2022,202210220WPG,Toronto Maple Leafs,TOR,0,WPG,4,6,10,26,12,11,1,2,3,31,26,17
2022-23,10/22/2022,202210220WSH,Los Angeles Kings,LAK,0,WSH,3,4,7,25,13,16,4,7,11,32,32,17
2022-23,10/22/2022,202210220BOS,Minnesota Wild,MIN,0,BOS,3,6,9,27,21,20,4,6,10,38,23,8
2022-23,10/22/2022,202210220CBJ,Pittsburgh Penguins,PIT,0,CBJ,5,9,14,38,10,16,3,2,5,30,31,15
2022-23,10/22/2022,202210220CGY,Calgary Flames,CGY,1,CAR,2,3,5,30,24,15,2,2,4,23,19,7
2022-23,10/22/2022,202210220EDM,St. Louis Blues,STL,0,EDM,2,3,5,22,29,25,0,0,0,23,27,7
2022-23,10/22/2022,202210220MTL,Montreal Canadiens,MTL,1,DAL,2,4,6,33,25,13,5,8,13,30,16,13
2022-23,10/22/2022,202210220NJD,San Jose Sharks,SJS,0,NJD,1,1,2,18,29,8,2,2,4,36,25,17
2022-23,10/22/2022,202210220NSH,Philadelphia Flyers,PHI,0,NSH,3,5,8,20,17,20,1,2,3,32,38,11
2022-23,10/22/2022,202210220OTT,Ottawa Senators,OTT,1,ARI,6,10,16,31,26,9,2,3,5,18,18,10
2022-23,10/22/2022,202210220TBL,Tampa Bay Lightning,TBL,1,NYI,5,9,14,26,29,20,3,1,4,35,45,9
2022-23,10/22/2022,202210220VAN,Vancouver Canucks,VAN,1,BUF,1,2,3,28,40,14,5,7,12,23,14,18
2022-23,10/22/2022,202210220VEG,Vegas Golden Knights,VEG,1,COL,2,4,6,33,41,27,3,5,8,25,38,16
2022-23,10/22/2022,202210220WPG,Winnipeg Jets,WPG,1,TOR,1,2,3,31,26,17,4,6,10,26,12,11
2022-23,10/22/2022,202210220WSH,Washington Capitals,WSH,1,LAK,4,7,11,32,32,17,3,4,7,25,13,16
2022-23,10/21/2022,202210210CHI,Chicago Blackhawks,CHI,1,DET,4,3,7,26,27,17,3,5,8,28,12,14
2022-23,10/21/2022,202210210COL,Colorado Avalanche,COL,1,SEA,2,4,6,20,36,8,2,5,7,37,17,15
2022-23,10/21/2022,202210210FLA,Florida Panthers,FLA,1,TBL,1,4,5,32,16,13,3,6,9,32,29,15
2022-23,10/21/2022,202210210CHI,Detroit Red Wings,DET,0,CHI,3,5,8,28,12,14,4,3,7,26,27,17
2022-23,10/21/2022,202210210COL,Seattle Kraken,SEA,0,COL,2,5,7,37,17,15,2,4,6,20,36,8
2022-23,10/21/2022,202210210FLA,Tampa Bay Lightning,TBL,0,FLA,3,6,9,32,29,15,1,4,5,32,16,13
2022-23,10/20/2022,202210200BOS,Anaheim Ducks,ANA,0,BOS,1,2,3,30,16,12,1,2,3,29,21,8
2022-23,10/20/2022,202210200CBJ,Columbus Blue Jackets,CBJ,1,NSH,5,7,12,41,27,19,3,6,9,26,15,19
2022-23,10/20/2022,202210200CGY,Buffalo Sabres,BUF,0,CGY,6,11,17,30,9,12,3,5,8,35,24,11
2022-23,10/20/2022,202210200EDM,Carolina Hurricanes,CAR,0,EDM,4,8,12,40,17,10,6,10,16,33,22,18
2022-23,10/20/2022,202210200MIN,Minnesota Wild,MIN,1,VAN,4,7,11,37,21,15,3,6,9,26,11,13
2022-23,10/20/2022,202210200MTL,Arizona Coyotes,ARI,0,MTL,2,4,6,26,19,13,6,3,9,28,13,15
2022-23,10/20/2022,202210200NYI,New Jersey Devils,NJD,0,NYI,4,5,9,43,21,21,1,2,3,16,37,16
2022-23,10/20/2022,202210200NYR,New York Rangers,NYR,1,SJS,2,3,5,23,33,18,2,6,8,25,16,11
2022-23,10/20/2022,202210200OTT,Ottawa Senators,OTT,1,WSH,5,7,12,42,27,10,2,4,6,24,24,21
2022-23,10/20/2022,202210200PIT,Los Angeles Kings,LAK,0,PIT,1,2,3,40,28,17,6,9,15,33,32,20
2022-23,10/20/2022,202210200TOR,Dallas Stars,DAL,0,TOR,2,4,6,28,41,15,3,6,9,43,31,21
2022-23,10/20/2022,202210200VEG,Vegas Golden Knights,VEG,1,WPG,5,7,12,31,22,10,2,4,6,28,28,8
2022-23,10/20/2022,202210200BOS,Boston Bruins,BOS,1,ANA,1,2,3,29,21,8,1,2,3,30,16,12
2022-23,10/20/2022,202210200CBJ,Nashville Predators,NSH,0,CBJ,3,6,9,26,15,19,5,7,12,41,27,19
2022-23,10/20/2022,202210200CGY,Calgary Flames,CGY,1,BUF,3,5,8,35,24,11,6,11,17,30,9,12
2022-23,10/20/2022,202210200EDM,Edmonton Oilers,EDM,1,CAR,6,10,16,33,22,18,4,8,12,40,17,10
2022-23,10/20/2022,202210200MIN,Vancouver Canucks,VAN,0,MIN,3,6,9,26,11,13,4,7,11,37,21,15
2022-23,10/20/2022,202210200MTL,Montreal Canadiens,MTL,1,ARI,6,3,9,28,13,15,2,4,6,26,19,13
2022-23,10/20/2022,202210200NYI,New York Islanders,NYI,1,NJD,1,2,3,16,37,16,4,5,9,43,21,21
2022-23,10/20/2022,202210200NYR,San Jose Sharks,SJS,0,NYR,2,6,8,25,16,11,2,3,5,23,33,18
2022-23,10/20/2022,202210200OTT,Washington Capitals,WSH,0,OTT,2,4,6,24,24,21,5,7,12,42,27,10
2022-23,10/20/2022,202210200PIT,Pittsburgh Penguins,PIT,1,LAK,6,9,15,33,32,20,1,2,3,40,28,17
2022-23,10/20/2022,202210200TOR,Toronto Maple Leafs,TOR,1,DAL,3,6,9,43,31,21,2,4,6,28,41,15
2022-23,10/20/2022,202210200VEG,Winnipeg Jets,WPG,0,VEG,2,4,6,28,28,8,5,7,12,31,22,10
2022-23,10/19/2022,202210190COL,Colorado Avalanche,COL,1,WPG,3,6,9,32,26,13,4,7,11,26,25,24
2022-23,10/19/2022,202210190FLA,Florida Panthers,FLA,1,PHI,3,8,11,31,7,8,3,6,9,30,13,14
2022-23,10/19/2022,202210190SEA,Seattle Kraken,SEA,1,STL,3,6,9,32,16,6,4,8,12,27,14,14
2022-23,10/19/2022,202210190COL,Winnipeg Jets,WPG,0,COL,4,7,11,26,25,24,3,6,9,32,26,13
2022-23,10/19/2022,202210190FLA,Philadelphia Flyers,PHI,0,FLA,3,6,9,30,13,14,3,8,11,31,7,8
2022-23,10/19/2022,202210190SEA,St. Louis Blues,STL,0,SEA,4,8,12,27,14,14,3,6,9,32,16,6
2022-23,10/18/2022,202210180CBJ,Columbus Blue Jackets,CBJ,1,VAN,4,6,10,32,16,15,3,5,8,33,13,13
2022-23,10/18/2022,202210180CGY,Calgary Flames,CGY,1,VEG,3,6,9,36,20,7,2,4,6,18,13,21
2022-23,10/18/2022,202210180EDM,Buffalo Sabres,BUF,0,EDM,4,4,8,23,16,13,2,3,5,47,25,10
2022-23,10/18/2022,202210180NJD,Anaheim Ducks,ANA,0,NJD,2,3,5,20,21,12,4,8,12,41,26,7
2022-23,10/18/2022,202210180NSH,Los Angeles Kings,LAK,0,NSH,3,5,8,35,20,12,3,5,8,32,31,17
2022-23,10/18/2022,202210180NYI,New York Islanders,NYI,1,SJS,5,8,13,44,28,13,1,2,3,24,19,18
2022-23,10/18/2022,202210180OTT,Boston Bruins,BOS,0,OTT,3,6,9,25,18,8,7,13,20,29,28,11
2022-23,10/18/2022,202210180TBL,Philadelphia Flyers,PHI,0,TBL,3,4,7,21,23,14,2,4,6,38,21,16
2022-23,10/18/2022,202210180CBJ,Vancouver Canucks,VAN,0,CBJ,3,5,8,33,13,13,4,6,10,32,16,15
2022-23,10/18/2022,202210180CGY,Vegas Golden Knights,VEG,0,CGY,2,4,6,18,13,21,3,6,9,36,20,7
2022-23,10/18/2022,202210180EDM,Edmonton Oilers,EDM,1,BUF,2,3,5,47,25,10,4,4,8,23,16,13
2022-23,10/18/2022,202210180NJD,New Jersey Devils,NJD,1,ANA,4,8,12,41,26,7,2,3,5,20,21,12
2022-23,10/18/2022,202210180NSH,Nashville Predators,NSH,1,LAK,3,5,8,32,31,17,3,5,8,35,20,12
2022-23,10/18/2022,202210180NYI,San Jose Sharks,SJS,0,NYI,1,2,3,24,19,18,5,8,13,44,28,13
2022-23,10/18/2022,202210180OTT,Ottawa Senators,OTT,1,BOS,7,13,20,29,28,11,3,6,9,25,18,8
2022-23,10/18/2022,202210180TBL,Tampa Bay Lightning,TBL,1,PHI,2,4,6,38,21,16,3,4,7,21,23,14
2022-23,10/17/2022,202210170BOS,Boston Bruins,BOS,1,FLA,4,4,8,26,14,15,3,5,8,36,20,18
2022-23,10/17/2022,202210170DAL,Dallas Stars,DAL,1,WPG,4,7,11,29,12,17,1,2,3,24,12,11
2022-23,10/17/2022,202210170DET,Detroit Red Wings,DET,1,LAK,4,8,12,30,29,15,5,9,14,36,13,11
2022-23,10/17/2022,202210170MIN,Colorado Avalanche,COL,0,MIN,6,10,16,38,21,16,3,6,9,39,20,11
2022-23,10/17/2022,202210170MTL,Montreal Canadiens,MTL,1,PIT,3,6,9,38,19,14,2,4,6,27,12,17
2022-23,10/17/2022,202210170NYR,Anaheim Ducks,ANA,0,NYR,3,8,11,19,15,11,6,12,18,43,27,13
2022-23,10/17/2022,202210170SEA,Carolina Hurricanes,CAR,0,SEA,5,10,15,31,16,10,1,2,3,23,18,15
2022-23,10/17/2022,202210170TOR,Arizona Coyotes,ARI,0,TOR,3,5,8,16,15,13,2,2,4,27,25,5
2022-23,10/17/2022,202210170WSH,Vancouver Canucks,VAN,0,WSH,4,8,12,30,31,13,6,11,17,30,37,14
2022-23,10/17/2022,202210170BOS,Florida Panthers,FLA,0,BOS,3,5,8,36,20,18,4,4,8,26,14,15
2022-23,10/17/2022,202210170DAL,Winnipeg Jets,WPG,0,DAL,1,2,3,24,12,11,4,7,11,29,12,17
2022-23,10/17/2022,202210170DET,Los Angeles Kings,LAK,0,DET,5,9,14,36,13,11,4,8,12,30,29,15
2022-23,10/17/2022,202210170MIN,Minnesota Wild,MIN,1,COL,3,6,9,39,20,11,6,10,16,38,21,16
2022-23,10/17/2022,202210170MTL,Pittsburgh Penguins,PIT,0,MTL,2,4,6,27,12,17,3,6,9,38,19,14
2022-23,10/17/2022,202210170NYR,New York Rangers,NYR,1,ANA,6,12,18,43,27,13,3,8,11,19,15,11
2022-23,10/17/2022,202210170SEA,Seattle Kraken,SEA,1,CAR,1,2,3,23,18,15,5,10,15,31,16,10
2022-23,10/17/2022,202210170TOR,Toronto Maple Leafs,TOR,1,ARI,2,2,4,27,25,5,3,5,8,16,15,13
2022-23,10/17/2022,202210170WSH,Washington Capitals,WSH,1,VAN,6,11,17,30,37,14,4,8,12,30,31,13
2022-23,10/15/2022,202210150BOS,Arizona Coyotes,ARI,0,BOS,3,4,7,21,26,18,6,8,14,37,24,11
2022-23,10/15/2022,202210150BUF,Buffalo Sabres,BUF,1,FLA,3,4,7,27,11,13,4,7,11,34,11,10
2022-23,10/15/2022,202210150DAL,Dallas Stars,DAL,1,NSH,5,6,11,22,13,14,1,2,3,30,17,18
2022-23,10/15/2022,202210150EDM,Calgary Flames,CGY,0,EDM,3,4,7,38,33,10,3,4,7,28,32,12
2022-23,10/15/2022,202210150MIN,Los Angeles Kings,LAK,0,MIN,7,14,21,34,4,20,6,11,17,35,20,7
2022-23,10/15/2022,202210150NJD,Detroit Red Wings,DET,0,NJD,5,10,15,21,22,19,2,4,6,39,19,11
2022-23,10/15/2022,202210150NYI,Anaheim Ducks,ANA,0,NYI,1,0,1,23,13,14,5,12,17,34,18,20
2022-23,10/15/2022,202210150PHI,Philadelphia Flyers,PHI,1,VAN,3,4,7,26,20,10,2,4,6,28,18,8
2022-23,10/15/2022,202210150PIT,Pittsburgh Penguins,PIT,1,TBL,6,10,16,44,37,12,2,4,6,36,20,14
2022-23,10/15/2022,202210150SEA,Seattle Kraken,SEA,1,VEG,2,4,6,32,26,9,5,8,13,28,12,20
2022-23,10/15/2022,202210150SJS,Chicago Blackhawks,CHI,0,SJS,4,9,13,22,21,17,2,4,6,25,14,3
2022-23,10/15/2022,202210150STL,Columbus Blue Jackets,CBJ,0,STL,2,4,6,23,14,13,5,7,12,25,28,13
2022-23,10/15/2022,202210150TOR,Ottawa Senators,OTT,0,TOR,2,4,6,28,53,19,3,5,8,31,30,11
2022-23,10/15/2022,202210150WSH,Montreal Canadiens,MTL,0,WSH,1,2,3,19,21,20,3,6,9,29,26,15
2022-23,10/15/2022,202210150BOS,Boston Bruins,BOS,1,ARI,6,8,14,37,24,11,3,4,7,21,26,18
2022-23,10/15/2022,202210150BUF,Florida Panthers,FLA,0,BUF,4,7,11,34,11,10,3,4,7,27,11,13
2022-23,10/15/2022,202210150DAL,Nashville Predators,NSH,0,DAL,1,2,3,30,17,18,5,6,11,22,13,14
2022-23,10/15/2022,202210150EDM,Edmonton Oilers,EDM,1,CGY,3,4,7,28,32,12,3,4,7,38,33,10
2022-23,10/15/2022,202210150MIN,Minnesota Wild,MIN,1,LAK,6,11,17,35,20,7,7,14,21,34,4,20
2022-23,10/15/2022,202210150NJD,New Jersey Devils,NJD,1,DET,2,4,6,39,19,11,5,10,15,21,22,19
2022-23,10/15/2022,202210150NYI,New York Islanders,NYI,1,ANA,5,12,17,34,18,20,1,0,1,23,13,14
2022-23,10/15/2022,202210150PHI,Vancouver Canucks,VAN,0,PHI,2,4,6,28,18,8,3,4,7,26,20,10
2022-23,10/15/2022,202210150PIT,Tampa Bay Lightning,TBL,0,PIT,2,4,6,36,20,14,6,10,16,44,37,12
2022-23,10/15/2022,202210150SEA,Vegas Golden Knights,VEG,0,SEA,5,8,13,28,12,20,2,4,6,32,26,9
2022-23,10/15/2022,202210150SJS,San Jose Sharks,SJS,1,CHI,2,4,6,25,14,3,4,9,13,22,21,17
2022-23,10/15/2022,202210150STL,St. Louis Blues,STL,1,CBJ,5,7,12,25,28,13,2,4,6,23,14,13
2022-23,10/15/2022,202210150TOR,Toronto Maple Leafs,TOR,1,OTT,3,5,8,31,30,11,2,4,6,28,53,19
2022-23,10/15/2022,202210150WSH,Washington Capitals,WSH,1,MTL,3,6,9,29,26,15,1,2,3,19,21,20
2022-23,10/14/2022,202210140CBJ,Columbus Blue Jackets,CBJ,1,TBL,2,4,6,25,22,12,5,10,15,39,17,4
2022-23,10/14/2022,202210140DET,Detroit Red Wings,DET,1,MTL,2,6,8,35,38,15,0,0,0,28,24,16
2022-23,10/14/2022,202210140SJS,Carolina Hurricanes,CAR,0,SJS,2,3,5,29,10,9,0,2,2,18,11,21
2022-23,10/14/2022,202210140WPG,New York Rangers,NYR,0,WPG,1,2,3,39,24,17,4,6,10,33,25,13
2022-23,10/14/2022,202210140CBJ,Tampa Bay Lightning,TBL,0,CBJ,5,10,15,39,17,4,2,4,6,25,22,12
2022-23,10/14/2022,202210140DET,Montreal Canadiens,MTL,0,DET,0,0,0,28,24,16,2,6,8,35,38,15
2022-23,10/14/2022,202210140SJS,San Jose Sharks,SJS,1,CAR,0,2,2,18,11,21,2,3,5,29,10,9
2022-23,10/14/2022,202210140WPG,Winnipeg Jets,WPG,1,NYR,4,6,10,33,25,13,1,2,3,39,24,17
2022-23,10/13/2022,202210130BUF,Buffalo Sabres,BUF,1,OTT,4,4,8,34,9,11,1,2,3,35,18,9
2022-23,10/13/2022,202210130CGY,Calgary Flames,CGY,1,COL,4,7,11,25,23,9,3,4,7,25,16,15
2022-23,10/13/2022,202210130LAK,Los Angeles Kings,LAK,1,SEA,1,0,1,26,27,8,4,5,9,22,43,15
2022-23,10/13/2022,202210130MIN,Minnesota Wild,MIN,1,NYR,3,4,7,36,20,13,7,11,18,35,27,13
2022-23,10/13/2022,202210130NSH,Dallas Stars,DAL,0,NSH,4,7,11,29,30,17,1,1,2,32,43,7
2022-23,10/13/2022,202210130NYI,Florida Panthers,FLA,0,NYI,2,3,5,24,15,11,1,2,3,28,31,22
2022-23,10/13/2022,202210130PHI,New Jersey Devils,NJD,0,PHI,2,3,5,37,18,9,4,8,12,21,26,27
2022-23,10/13/2022,202210130PIT,Arizona Coyotes,ARI,0,PIT,0,4,4,21,29,8,6,12,18,49,26,15
2022-23,10/13/2022,202210130TOR,Toronto Maple Leafs,TOR,1,WSH,3,6,9,36,34,17,2,4,6,26,33,9
2022-23,10/13/2022,202210130VEG,Chicago Blackhawks,CHI,0,VEG,0,0,0,26,41,19,1,1,2,35,20,18
2022-23,10/13/2022,202210130BUF,Ottawa Senators,OTT,0,BUF,1,2,3,35,18,9,4,4,8,34,9,11
2022-23,10/13/2022,202210130CGY,Colorado Avalanche,COL,0,CGY,3,4,7,25,16,15,4,7,11,25,23,9
2022-23,10/13/2022,202210130LAK,Seattle Kraken,SEA,0,LAK,4,5,9,22,43,15,1,0,1,26,27,8
2022-23,10/13/2022,202210130MIN,New York Rangers,NYR,0,MIN,7,11,18,35,27,13,3,4,7,36,20,13
2022-23,10/13/2022,202210130NSH,Nashville Predators,NSH,1,DAL,1,1,2,32,43,7,4,7,11,29,30,17
2022-23,10/13/2022,202210130NYI,New York Islanders,NYI,1,FLA,1,2,3,28,31,22,2,3,5,24,15,11
2022-23,10/13/2022,202210130PHI,Philadelphia Flyers,PHI,1,NJD,4,8,12,21,26,27,2,3,5,37,18,9
2022-23,10/13/2022,202210130PIT,Pittsburgh Penguins,PIT,1,ARI,6,12,18,49,26,15,0,4,4,21,29,8
2022-23,10/13/2022,202210130TOR,Washington Capitals,WSH,0,TOR,2,4,6,26,33,9,3,6,9,36,34,17
2022-23,10/13/2022,202210130VEG,Vegas Golden Knights,VEG,1,CHI,1,1,2,35,20,18,0,0,0,26,41,19
2022-23,10/12/2022,202210120ANA,Anaheim Ducks,ANA,1,SEA,5,8,13,27,14,9,4,7,11,45,20,11
2022-23,10/12/2022,202210120CAR,Carolina Hurricanes,CAR,1,CBJ,4,4,8,40,19,9,1,1,2,31,26,20
2022-23,10/12/2022,202210120COL,Chicago Blackhawks,CHI,0,COL,1,4,5,14,29,13,5,10,15,34,30,9
2022-23,10/12/2022,202210120EDM,Edmonton Oilers,EDM,1,VAN,5,8,13,24,38,14,3,4,7,32,25,15
2022-23,10/12/2022,202210120MTL,Montreal Canadiens,MTL,1,TOR,4,5,9,22,19,21,2,6,8,27,15,9
2022-23,10/12/2022,202210120WSH,Boston Bruins,BOS,0,WSH,3,6,9,25,31,15,2,3,5,35,48,13
2022-23,10/12/2022,202210120ANA,Seattle Kraken,SEA,0,ANA,4,7,11,45,20,11,5,8,13,27,14,9
2022-23,10/12/2022,202210120CAR,Columbus Blue Jackets,CBJ,0,CAR,1,1,2,31,26,20,4,4,8,40,19,9
2022-23,10/12/2022,202210120COL,Colorado Avalanche,COL,1,CHI,5,10,15,34,30,9,1,4,5,14,29,13
2022-23,10/12/2022,202210120EDM,Vancouver Canucks,VAN,0,EDM,3,4,7,32,25,15,5,8,13,24,38,14
2022-23,10/12/2022,202210120MTL,Toronto Maple Leafs,TOR,0,MTL,2,6,8,27,15,9,4,5,9,22,19,21
2022-23,10/12/2022,202210120WSH,Washington Capitals,WSH,1,BOS,2,3,5,35,48,13,3,6,9,25,31,15
2022-23,10/11/2022,202210110LAK,Los Angeles Kings,LAK,1,VEG,3,6,9,29,20,20,4,7,11,48,25,13
2022-23,10/11/2022,202210110NYR,New York Rangers,NYR,1,TBL,3,6,9,39,24,12,1,2,3,26,19,22
2022-23,10/11/2022,202210110LAK,Vegas Golden Knights,VEG,0,LAK,4,7,11,48,25,13,3,6,9,29,20,20
2022-23,10/11/2022,202210110NYR,Tampa Bay Lightning,TBL,0,NYR,1,2,3,26,19,22,3,6,9,39,24,12
2022-23,10/8/2022,202210080SJS,Nashville Predators,NSH,0,SJS,3,6,9,18,33,23,2,4,6,32,21,16
2022-23,10/8/2022,202210080SJS,San Jose Sharks,SJS,1,NSH,2,4,6,32,21,16,3,6,9,18,33,23
2022-23,10/7/2022,202210070NSH,Nashville Predators,NSH,1,SJS,4,8,12,31,20,11,1,2,3,29,20,19
2022-23,10/7/2022,202210070NSH,San Jose Sharks,SJS,0,NSH,1,2,3,29,20,19,4,8,12,31,20,11
